"uid";"name";"nbContributions";"nbDayContributions";"nbNightContributions";"nbOfweekContributions";"nbOfweekendContributions";"nbCreations";"nbModifications";"nbDeletes";"nbBlockReceived";"totalChangesetCount";"p_DayContributions";"p_NightContributions";"p_OfweekContributions";"p_OfweekendContributions";"p_Creations";"p_Modifications";"p_Deletes";"nbChangesetFenetre"
"2420780";"bkkboy18";"10";"0";"10";"10";"0";"5";"4";"1";"0";"5";"0.0";"1.0";"1.0";"0.0";"0.5";"0.4";"0.1";"5"
"244754";"Janjko";"2";"0";"2";"0";"2";"0";"2";"0";"0";"54332";"0.0";"1.0";"0.0";"1.0";"0.0";"1.0";"0.0";"2"
"449555";"Jérôme Vouillon";"102";"23";"79";"92";"10";"23";"67";"12";"0";"526";"0.22549019607843138";"0.7745098039215687";"0.9019607843137255";"0.09803921568627451";"0.22549019607843138";"0.6568627450980392";"0.11764705882352941";"19"
"2885684";"Ane Maria";"3";"0";"3";"0";"3";"1";"2";"0";"0";"8";"0.0";"1.0";"0.0";"1.0";"0.3333333333333333";"0.6666666666666666";"0.0";"1"
"1198089";"GeorgeKaplan";"791";"127";"664";"523";"268";"104";"558";"129";"0";"1536";"0.16055625790139064";"0.8394437420986094";"0.661188369152971";"0.3388116308470291";"0.13147914032869784";"0.7054361567635904";"0.16308470290771176";"95"
"2860087";"Lionel TREILLARD";"12";"12";"0";"12";"0";"0";"12";"0";"0";"15";"1.0";"0.0";"1.0";"0.0";"0.0";"1.0";"0.0";"2"
"1144846";"rdfs";"2";"2";"0";"2";"0";"1";"1";"0";"0";"11";"1.0";"0.0";"1.0";"0.0";"0.5";"0.5";"0.0";"2"
"93222";"InfosReseaux";"32";"0";"32";"2";"30";"3";"29";"0";"0";"1137";"0.0";"1.0";"0.0625";"0.9375";"0.09375";"0.90625";"0.0";"2"
"343084";"andreib";"1";"1";"0";"1";"0";"0";"1";"0";"0";"138";"1.0";"0.0";"1.0";"0.0";"0.0";"1.0";"0.0";"1"
"1313848";"Ulmon Community";"7";"7";"0";"7";"0";"7";"0";"0";"0";"281";"1.0";"0.0";"1.0";"0.0";"1.0";"0.0";"0.0";"7"
"462898";"alexanderW";"54";"0";"54";"0";"54";"4";"50";"0";"0";"317";"0.0";"1.0";"0.0";"1.0";"0.07407407407407407";"0.9259259259259259";"0.0";"1"
"99386";"masti";"1";"0";"1";"1";"0";"0";"1";"0";"0";"7755";"0.0";"1.0";"1.0";"0.0";"0.0";"1.0";"0.0";"1"
"497734";"benchoufi";"1";"1";"0";"1";"0";"1";"0";"0";"0";"12";"1.0";"0.0";"1.0";"0.0";"1.0";"0.0";"0.0";"1"
"1712217";"mazootman";"8";"8";"0";"0";"8";"0";"0";"8";"0";"318";"1.0";"0.0";"0.0";"1.0";"0.0";"0.0";"1.0";"1"
"247879";"victorenator";"4";"4";"0";"4";"0";"0";"4";"0";"0";"4809";"1.0";"0.0";"1.0";"0.0";"0.0";"1.0";"0.0";"1"
"1960024";"BuganiniQ";"3";"1";"2";"3";"0";"0";"3";"0";"0";"404";"0.3333333333333333";"0.6666666666666666";"1.0";"0.0";"0.0";"1.0";"0.0";"2"
"1440848";"SeeSchloss";"6";"6";"0";"6";"0";"6";"0";"0";"0";"78";"1.0";"0.0";"1.0";"0.0";"1.0";"0.0";"0.0";"1"
"153669";"dchiles";"9";"6";"3";"9";"0";"2";"5";"2";"0";"12642";"0.6666666666666666";"0.3333333333333333";"1.0";"0.0";"0.2222222222222222";"0.5555555555555556";"0.2222222222222222";"3"
"2169960";"Benjamin Lanet";"4";"4";"0";"4";"0";"1";"3";"0";"0";"10";"1.0";"0.0";"1.0";"0.0";"0.25";"0.75";"0.0";"4"
"38985";"Johnny Carlsen";"1";"1";"0";"1";"0";"1";"0";"0";"0";"21107";"1.0";"0.0";"1.0";"0.0";"1.0";"0.0";"0.0";"1"
"247886";"teufli";"4";"0";"4";"4";"0";"3";"1";"0";"0";"317";"0.0";"1.0";"1.0";"0.0";"0.75";"0.25";"0.0";"4"
"319572";"Martien Sch";"1";"0";"1";"1";"0";"1";"0";"0";"0";"5643";"0.0";"1.0";"1.0";"0.0";"1.0";"0.0";"0.0";"1"
"1955918";"SachaC";"464";"464";"0";"0";"464";"204";"234";"26";"0";"7";"1.0";"0.0";"0.0";"1.0";"0.4396551724137931";"0.5043103448275862";"0.05603448275862069";"7"
"62548";"Coucouf";"353";"209";"144";"197";"156";"208";"133";"12";"0";"2622";"0.5920679886685553";"0.40793201133144474";"0.5580736543909348";"0.44192634560906513";"0.5892351274787535";"0.37677053824362605";"0.0339943342776204";"155"
"1424448";"nlehuby";"68";"14";"54";"40";"28";"1";"67";"0";"0";"7537";"0.20588235294117646";"0.7941176470588235";"0.5882352941176471";"0.4117647058823529";"0.014705882352941176";"0.9852941176470589";"0.0";"33"
"69716";"Circeus";"1";"0";"1";"1";"0";"1";"0";"0";"0";"1243";"0.0";"1.0";"1.0";"0.0";"1.0";"0.0";"0.0";"1"
"996441";"Fifi Fofo";"66";"37";"29";"66";"0";"42";"24";"0";"0";"625";"0.5606060606060606";"0.4393939393939394";"1.0";"0.0";"0.6363636363636364";"0.36363636363636365";"0.0";"6"
"2146423";"adi_z";"3";"3";"0";"3";"0";"1";"2";"0";"0";"3231";"1.0";"0.0";"1.0";"0.0";"0.3333333333333333";"0.6666666666666666";"0.0";"3"
"312413";"DRW";"2";"0";"2";"2";"0";"2";"0";"0";"0";"535";"0.0";"1.0";"1.0";"0.0";"1.0";"0.0";"0.0";"1"
"2514042";"sillon";"1";"0";"1";"1";"0";"0";"1";"0";"0";"857";"0.0";"1.0";"1.0";"0.0";"0.0";"1.0";"0.0";"1"
"2270335";"woshilapin";"4";"4";"0";"4";"0";"1";"3";"0";"0";"22";"1.0";"0.0";"1.0";"0.0";"0.25";"0.75";"0.0";"4"
"1072240";"cmif4";"6157";"5753";"404";"6157";"0";"3298";"2211";"648";"0";"1387";"0.9343836283904499";"0.06561637160955011";"1.0";"0.0";"0.5356504791294462";"0.35910345947701805";"0.10524606139353582";"122"
"88164";"Med";"7";"6";"1";"1";"6";"0";"7";"0";"0";"2491";"0.8571428571428571";"0.14285714285714285";"0.14285714285714285";"0.8571428571428571";"0.0";"1.0";"0.0";"3"
"2311236";"fougris";"1";"1";"0";"1";"0";"0";"1";"0";"0";"2";"1.0";"0.0";"1.0";"0.0";"0.0";"1.0";"0.0";"1"
"236651";"Sanjak";"10";"1";"9";"10";"0";"0";"10";"0";"0";"4247";"0.1";"0.9";"1.0";"0.0";"0.0";"1.0";"0.0";"7"
"158826";"cquest";"2648";"1890";"758";"516";"2132";"505";"2043";"100";"0";"15262";"0.7137462235649547";"0.2862537764350453";"0.19486404833836857";"0.8051359516616314";"0.19070996978851965";"0.7715256797583081";"0.0377643504531722";"66"
"1219704";"mitchellm";"1";"1";"0";"0";"1";"0";"1";"0";"0";"1";"1.0";"0.0";"0.0";"1.0";"0.0";"1.0";"0.0";"1"
"1541221";"Diny64";"1";"1";"0";"1";"0";"1";"0";"0";"0";"42";"1.0";"0.0";"1.0";"0.0";"1.0";"0.0";"0.0";"1"
"1778799";"SomeoneElse_Revert";"3";"0";"3";"3";"0";"0";"3";"0";"0";"2968";"0.0";"1.0";"1.0";"0.0";"0.0";"1.0";"0.0";"2"
"352368";"zehpunktbarron";"1";"1";"0";"1";"0";"0";"1";"0";"0";"6014";"1.0";"0.0";"1.0";"0.0";"0.0";"1.0";"0.0";"1"
"849013";"thibautRe";"12";"7";"5";"10";"2";"6";"5";"1";"0";"761";"0.5833333333333334";"0.4166666666666667";"0.8333333333333334";"0.16666666666666666";"0.5";"0.4166666666666667";"0.08333333333333333";"7"
"270456";"pyrog";"4";"4";"0";"3";"1";"0";"4";"0";"0";"1741";"1.0";"0.0";"0.75";"0.25";"0.0";"1.0";"0.0";"2"
"15489";"vmeurisse";"1";"0";"1";"1";"0";"0";"0";"1";"0";"634";"0.0";"1.0";"1.0";"0.0";"0.0";"0.0";"1.0";"1"
"2479270";"GéoVélo Rennes Métropole";"6";"0";"6";"1";"5";"0";"5";"1";"0";"535";"0.0";"1.0";"0.16666666666666666";"0.8333333333333334";"0.0";"0.8333333333333334";"0.16666666666666666";"3"
"163973";"badpap";"1";"1";"0";"0";"1";"0";"1";"0";"1";"4112";"1.0";"0.0";"0.0";"1.0";"0.0";"1.0";"0.0";"1"
"98443";"pierrelm";"13";"13";"0";"1";"12";"1";"12";"0";"0";"661";"1.0";"0.0";"0.07692307692307693";"0.9230769230769231";"0.07692307692307693";"0.9230769230769231";"0.0";"2"
"2305193";"PresDuLac";"15";"0";"15";"15";"0";"1";"12";"2";"0";"6";"0.0";"1.0";"1.0";"0.0";"0.06666666666666667";"0.8";"0.13333333333333333";"6"
"921732";"IsatisBleu";"2";"2";"0";"2";"0";"0";"2";"0";"0";"408";"1.0";"0.0";"1.0";"0.0";"0.0";"1.0";"0.0";"1"
"1922193";"Superadlen";"1";"1";"0";"0";"1";"0";"1";"0";"0";"4818";"1.0";"0.0";"0.0";"1.0";"0.0";"1.0";"0.0";"1"
"702619";"Migolu";"3";"3";"0";"3";"0";"0";"2";"1";"0";"60";"1.0";"0.0";"1.0";"0.0";"0.0";"0.6666666666666666";"0.3333333333333333";"2"
"8339";"mtmail";"1";"1";"0";"1";"0";"0";"1";"0";"0";"3141";"1.0";"0.0";"1.0";"0.0";"0.0";"1.0";"0.0";"1"
"1544322";"Paul Mallet";"124";"34";"90";"66";"58";"36";"88";"0";"0";"642";"0.27419354838709675";"0.7258064516129032";"0.532258064516129";"0.46774193548387094";"0.2903225806451613";"0.7096774193548387";"0.0";"19"
"183450";"cypriend";"2";"1";"1";"2";"0";"1";"1";"0";"0";"650";"0.5";"0.5";"1.0";"0.0";"0.5";"0.5";"0.0";"2"
"46239";"MatthieuMartin";"41";"1";"40";"37";"4";"0";"41";"0";"0";"2857";"0.024390243902439025";"0.975609756097561";"0.9024390243902439";"0.0975609756097561";"0.0";"1.0";"0.0";"7"
"475302";"SProvost";"1";"1";"0";"1";"0";"0";"1";"0";"0";"16";"1.0";"0.0";"1.0";"0.0";"0.0";"1.0";"0.0";"1"
"2333826";"Mohamed KHELIFI";"1";"1";"0";"1";"0";"0";"1";"0";"0";"414";"1.0";"0.0";"1.0";"0.0";"0.0";"1.0";"0.0";"1"
"25762";"frodrigo";"107";"107";"0";"78";"29";"29";"49";"29";"0";"4740";"1.0";"0.0";"0.7289719626168224";"0.27102803738317754";"0.27102803738317754";"0.45794392523364486";"0.27102803738317754";"3"
"184480";"gaspard";"7";"7";"0";"2";"5";"1";"6";"0";"0";"614";"1.0";"0.0";"0.2857142857142857";"0.7142857142857143";"0.14285714285714285";"0.8571428571428571";"0.0";"2"
"530603";"la colle";"3";"2";"1";"0";"3";"0";"3";"0";"0";"4576";"0.6666666666666666";"0.3333333333333333";"0.0";"1.0";"0.0";"1.0";"0.0";"2"
"268455";"nfrery";"1";"0";"1";"1";"0";"0";"1";"0";"0";"4820";"0.0";"1.0";"1.0";"0.0";"0.0";"1.0";"0.0";"1"
"150692";"gcamp";"10";"8";"2";"10";"0";"6";"4";"0";"0";"286";"0.8";"0.2";"1.0";"0.0";"0.6";"0.4";"0.0";"2"
"227498";"Seudo";"12";"12";"0";"0";"12";"0";"8";"4";"0";"59";"1.0";"0.0";"0.0";"1.0";"0.0";"0.6666666666666666";"0.3333333333333333";"5"
"1848501";"hannes_r";"1";"0";"1";"0";"1";"1";"0";"0";"0";"11";"0.0";"1.0";"0.0";"1.0";"1.0";"0.0";"0.0";"1"
"3099780";"Armire";"1";"0";"1";"1";"0";"0";"1";"0";"0";"6209";"0.0";"1.0";"1.0";"0.0";"0.0";"1.0";"0.0";"1"
"2745477";"Renaud Allard";"1";"0";"1";"0";"1";"1";"0";"0";"0";"50";"0.0";"1.0";"0.0";"1.0";"1.0";"0.0";"0.0";"1"
"19630";"Hooloovoo";"4";"3";"1";"1";"3";"4";"0";"0";"0";"180";"0.75";"0.25";"0.25";"0.75";"1.0";"0.0";"0.0";"2"
"7344";"moenk";"2";"2";"0";"2";"0";"0";"2";"0";"0";"713";"1.0";"0.0";"1.0";"0.0";"0.0";"1.0";"0.0";"1"
"2117777";"ATRC";"1";"1";"0";"1";"0";"1";"0";"0";"0";"3";"1.0";"0.0";"1.0";"0.0";"1.0";"0.0";"0.0";"1"
"2070701";"OpenBeerMapContributor";"35";"27";"8";"30";"5";"0";"35";"0";"0";"2260";"0.7714285714285715";"0.22857142857142856";"0.8571428571428571";"0.14285714285714285";"0.0";"1.0";"0.0";"34"
"680121";"j3d";"91";"91";"0";"0";"91";"21";"62";"8";"0";"470";"1.0";"0.0";"0.0";"1.0";"0.23076923076923078";"0.6813186813186813";"0.08791208791208792";"1"
"1186986";"20-100";"1";"0";"1";"0";"1";"0";"1";"0";"0";"1";"0.0";"1.0";"0.0";"1.0";"0.0";"1.0";"0.0";"1"
"2117785";"riomoscowexpress";"1";"1";"0";"1";"0";"1";"0";"0";"0";"2";"1.0";"0.0";"1.0";"0.0";"1.0";"0.0";"0.0";"1"
"224440";"Syl";"11";"3";"8";"6";"5";"1";"7";"3";"0";"10775";"0.2727272727272727";"0.7272727272727273";"0.5454545454545454";"0.45454545454545453";"0.09090909090909091";"0.6363636363636364";"0.2727272727272727";"7"
"128186";"malcolmh";"2";"2";"0";"0";"2";"0";"2";"0";"2";"13781";"1.0";"0.0";"0.0";"1.0";"0.0";"1.0";"0.0";"1"
"194751";"Goffredo";"18";"4";"14";"6";"12";"3";"14";"1";"0";"3296";"0.2222222222222222";"0.7777777777777778";"0.3333333333333333";"0.6666666666666666";"0.16666666666666666";"0.7777777777777778";"0.05555555555555555";"7"
"200894";"Axone";"2";"2";"0";"2";"0";"0";"2";"0";"0";"245";"1.0";"0.0";"1.0";"0.0";"0.0";"1.0";"0.0";"1"
"194754";"jfcha";"3";"3";"0";"0";"3";"0";"3";"0";"0";"1232";"1.0";"0.0";"0.0";"1.0";"0.0";"1.0";"0.0";"2"
"667850";"Liberal";"1";"1";"0";"1";"0";"0";"1";"0";"0";"290";"1.0";"0.0";"1.0";"0.0";"0.0";"1.0";"0.0";"1"
"165061";"mapper999";"164";"3";"161";"27";"137";"121";"37";"6";"0";"16310";"0.018292682926829267";"0.9817073170731707";"0.16463414634146342";"0.8353658536585366";"0.7378048780487805";"0.22560975609756098";"0.036585365853658534";"7"
"1814748";"Webtress";"1";"0";"1";"1";"0";"1";"0";"0";"0";"1";"0.0";"1.0";"1.0";"0.0";"1.0";"0.0";"0.0";"1"
"1816789";"Adormo";"3";"0";"3";"3";"0";"1";"2";"0";"0";"111";"0.0";"1.0";"1.0";"0.0";"0.3333333333333333";"0.6666666666666666";"0.0";"3"
"2089159";"Manuel Guesdon";"1";"1";"0";"1";"0";"1";"0";"0";"0";"2";"1.0";"0.0";"1.0";"0.0";"1.0";"0.0";"0.0";"1"
"705744";"Jean-Marc Gailis";"147";"54";"93";"38";"109";"43";"81";"23";"0";"88";"0.3673469387755102";"0.6326530612244898";"0.2585034013605442";"0.7414965986394558";"0.2925170068027211";"0.5510204081632653";"0.1564625850340136";"27"
"1256648";"Zigeuner";"8";"2";"6";"5";"3";"1";"7";"0";"0";"2767";"0.25";"0.75";"0.625";"0.375";"0.125";"0.875";"0.0";"8"
"524500";"wheelmap_android";"1";"0";"1";"1";"0";"0";"1";"0";"0";"9743";"0.0";"1.0";"1.0";"0.0";"0.0";"1.0";"0.0";"1"
"1214670";"Ben Siesta";"18";"15";"3";"14";"4";"4";"10";"4";"0";"92";"0.8333333333333334";"0.16666666666666666";"0.7777777777777778";"0.2222222222222222";"0.2222222222222222";"0.5555555555555556";"0.2222222222222222";"14"
"617687";"ralevy";"19";"19";"0";"3";"16";"11";"8";"0";"0";"927";"1.0";"0.0";"0.15789473684210525";"0.8421052631578947";"0.5789473684210527";"0.42105263157894735";"0.0";"16"
"6367";"mackerski";"1";"1";"0";"0";"1";"1";"0";"0";"0";"27321";"1.0";"0.0";"0.0";"1.0";"1.0";"0.0";"0.0";"1"
"445671";"flierfy";"6";"4";"2";"6";"0";"0";"6";"0";"0";"5187";"0.6666666666666666";"0.3333333333333333";"1.0";"0.0";"0.0";"1.0";"0.0";"2"
"41187";"Matt Toups";"2";"0";"2";"0";"2";"1";"1";"0";"0";"1924";"0.0";"1.0";"0.0";"1.0";"0.5";"0.5";"0.0";"1"
"85218";"Aleks-Berlin";"3";"1";"2";"1";"2";"0";"3";"0";"2";"25456";"0.3333333333333333";"0.6666666666666666";"0.3333333333333333";"0.6666666666666666";"0.0";"1.0";"0.0";"3"
"130277";"Teuxe";"5";"5";"0";"5";"0";"1";"4";"0";"0";"2537";"1.0";"0.0";"1.0";"0.0";"0.2";"0.8";"0.0";"3"
"322785";"BCNorwich";"5";"2";"3";"5";"0";"1";"3";"1";"0";"63962";"0.4";"0.6";"1.0";"0.0";"0.2";"0.6";"0.2";"3"
"704748";"tiguillom";"1";"1";"0";"1";"0";"0";"1";"0";"0";"92";"1.0";"0.0";"1.0";"0.0";"0.0";"1.0";"0.0";"1"
"2928838";"Thomas Renault";"1";"1";"0";"1";"0";"1";"0";"0";"0";"30";"1.0";"0.0";"1.0";"0.0";"1.0";"0.0";"0.0";"1"
"39149";"Joce";"10";"3";"7";"0";"10";"3";"7";"0";"0";"15";"0.3";"0.7";"0.0";"1.0";"0.3";"0.7";"0.0";"2"
"2419913";"jm-gailis";"1";"1";"0";"1";"0";"0";"1";"0";"0";"4";"1.0";"0.0";"1.0";"0.0";"0.0";"1.0";"0.0";"1"
"638183";"RicoZ";"2";"0";"2";"0";"2";"0";"2";"0";"0";"1060";"0.0";"1.0";"0.0";"1.0";"0.0";"1.0";"0.0";"1"
"5359";"user_5359";"9";"0";"9";"0";"9";"0";"9";"0";"0";"35753";"0.0";"1.0";"0.0";"1.0";"0.0";"1.0";"0.0";"1"
"2790597";"Staffly";"1";"1";"0";"0";"1";"0";"1";"0";"0";"1";"1.0";"0.0";"0.0";"1.0";"0.0";"1.0";"0.0";"1"
"412919";"gpermant";"1";"0";"1";"1";"0";"1";"0";"0";"0";"2023";"0.0";"1.0";"1.0";"0.0";"1.0";"0.0";"0.0";"1"
"480502";"phparis";"4";"4";"0";"4";"0";"0";"4";"0";"0";"28";"1.0";"0.0";"1.0";"0.0";"0.0";"1.0";"0.0";"1"
"376055";"Nicolas Bétheuil";"1";"0";"1";"1";"0";"0";"1";"0";"0";"429";"0.0";"1.0";"1.0";"0.0";"0.0";"1.0";"0.0";"1"
"492784";"Erkkii";"46";"46";"0";"16";"30";"19";"23";"4";"0";"502";"1.0";"0.0";"0.34782608695652173";"0.6521739130434783";"0.41304347826086957";"0.5";"0.08695652173913043";"9"
"210173";"osmmaker";"5630";"3884";"1746";"4548";"1082";"3578";"1935";"117";"11";"7285";"0.6898756660746004";"0.3101243339253996";"0.8078152753108349";"0.1921847246891652";"0.6355239786856128";"0.34369449378330375";"0.02078152753108348";"140"
"2089185";"eikooc";"1";"1";"0";"1";"0";"0";"1";"0";"0";"16";"1.0";"0.0";"1.0";"0.0";"0.0";"1.0";"0.0";"1"
"197884";"Higonnet";"8";"8";"0";"8";"0";"4";"4";"0";"0";"254";"1.0";"0.0";"1.0";"0.0";"0.5";"0.5";"0.0";"1"
"1996062";"McLedice";"15";"15";"0";"15";"0";"0";"6";"9";"0";"1";"1.0";"0.0";"1.0";"0.0";"0.0";"0.4";"0.6";"1"
"672008";"Benux";"1";"1";"0";"0";"1";"0";"1";"0";"0";"402";"1.0";"0.0";"0.0";"1.0";"0.0";"1.0";"0.0";"1"
"118021";"maggot27";"2";"1";"1";"0";"2";"0";"1";"1";"0";"8185";"0.5";"0.5";"0.0";"1.0";"0.0";"0.5";"0.5";"2"
"1798428";"Fredo75001";"1";"1";"0";"1";"0";"1";"0";"0";"0";"1";"1.0";"0.0";"1.0";"0.0";"1.0";"0.0";"0.0";"1"
"1944853";"Manon Calame";"56";"56";"0";"2";"54";"45";"11";"0";"0";"9";"1.0";"0.0";"0.03571428571428571";"0.9642857142857143";"0.8035714285714286";"0.19642857142857142";"0.0";"8"
"86289";"Gustry";"1";"0";"1";"1";"0";"0";"1";"0";"0";"2503";"0.0";"1.0";"1.0";"0.0";"0.0";"1.0";"0.0";"1"
"37137";"Derick Rethans";"2";"0";"2";"0";"2";"1";"1";"0";"0";"3717";"0.0";"1.0";"0.0";"1.0";"0.5";"0.5";"0.0";"1"
"316694";"Luiyo";"7";"7";"0";"0";"7";"2";"5";"0";"0";"10378";"1.0";"0.0";"0.0";"1.0";"0.2857142857142857";"0.7142857142857143";"0.0";"2"
"662809";"Miavl";"1";"0";"1";"1";"0";"0";"1";"0";"0";"839";"0.0";"1.0";"1.0";"0.0";"0.0";"1.0";"0.0";"1"
"278800";"tbicr";"1";"1";"0";"0";"1";"0";"1";"0";"0";"1881";"1.0";"0.0";"0.0";"1.0";"0.0";"1.0";"0.0";"1"
"2620721";"silviaoa";"12";"12";"0";"0";"12";"6";"4";"2";"0";"13";"1.0";"0.0";"0.0";"1.0";"0.5";"0.3333333333333333";"0.16666666666666666";"8"
"131348";"Liu Linlin";"5";"0";"5";"5";"0";"4";"1";"0";"0";"1";"0.0";"1.0";"1.0";"0.0";"0.8";"0.2";"0.0";"1"
"67862";"HolgerJeromin";"2";"0";"2";"2";"0";"0";"2";"0";"0";"12457";"0.0";"1.0";"1.0";"0.0";"0.0";"1.0";"0.0";"2"
"562452";"RPVN";"1";"1";"0";"1";"0";"0";"1";"0";"0";"162";"1.0";"0.0";"1.0";"0.0";"0.0";"1.0";"0.0";"1"
"375079";"Black Myst";"20";"2";"18";"5";"15";"0";"20";"0";"0";"1809";"0.1";"0.9";"0.25";"0.75";"0.0";"1.0";"0.0";"14"
"1722685";"Lawrie Hodges";"1";"0";"1";"1";"0";"0";"1";"0";"0";"29";"0.0";"1.0";"1.0";"0.0";"0.0";"1.0";"0.0";"1"
"359725";"oligo";"32";"31";"1";"0";"32";"0";"27";"5";"0";"577";"0.96875";"0.03125";"0.0";"1.0";"0.0";"0.84375";"0.15625";"3"
"160042";"Jean-Marc Liotier";"1";"1";"0";"1";"0";"0";"1";"0";"0";"3579";"1.0";"0.0";"1.0";"0.0";"0.0";"1.0";"0.0";"1"
"867616";"kds0102";"4";"0";"4";"0";"4";"0";"4";"0";"0";"3";"0.0";"1.0";"0.0";"1.0";"0.0";"1.0";"0.0";"1"
"3447046";"David Benoist";"2";"2";"0";"2";"0";"1";"1";"0";"0";"3";"1.0";"0.0";"1.0";"0.0";"0.5";"0.5";"0.0";"2"
"593214";"gileri";"13";"0";"13";"2";"11";"0";"13";"0";"0";"3094";"0.0";"1.0";"0.15384615384615385";"0.8461538461538461";"0.0";"1.0";"0.0";"4"
"21817";"BBecquet";"5";"5";"0";"5";"0";"3";"2";"0";"0";"218";"1.0";"0.0";"1.0";"0.0";"0.6";"0.4";"0.0";"2"
"127299";"Batareikin";"2";"2";"0";"0";"2";"0";"2";"0";"1";"2073";"1.0";"0.0";"0.0";"1.0";"0.0";"1.0";"0.0";"1"
"85314";"Samusz";"70";"52";"18";"19";"51";"46";"23";"1";"0";"2091";"0.7428571428571429";"0.2571428571428571";"0.2714285714285714";"0.7285714285714285";"0.6571428571428571";"0.32857142857142857";"0.014285714285714285";"16"
"2154858";"mboeringa";"4";"1";"3";"4";"0";"0";"4";"0";"0";"2232";"0.25";"0.75";"1.0";"0.0";"0.0";"1.0";"0.0";"2"
"1819985";"Pinkman";"1";"0";"1";"1";"0";"1";"0";"0";"0";"14";"0.0";"1.0";"1.0";"0.0";"1.0";"0.0";"0.0";"1"
"1959254";"maphnsj";"1";"0";"1";"0";"1";"0";"1";"0";"1";"28475";"0.0";"1.0";"0.0";"1.0";"0.0";"1.0";"0.0";"1"
"143703";"Britz";"94";"65";"29";"52";"42";"43";"46";"5";"0";"2890";"0.6914893617021277";"0.30851063829787234";"0.5531914893617021";"0.44680851063829785";"0.4574468085106383";"0.48936170212765956";"0.05319148936170213";"6"
"2242882";"GautierMoin";"2";"2";"0";"0";"2";"0";"2";"0";"0";"21";"1.0";"0.0";"0.0";"1.0";"0.0";"1.0";"0.0";"1"
"3299669";"michko2";"1";"0";"1";"0";"1";"0";"1";"0";"0";"1";"0.0";"1.0";"0.0";"1.0";"0.0";"1.0";"0.0";"1"
"2214221";"ebruxelles";"1";"1";"0";"0";"1";"0";"1";"0";"0";"9";"1.0";"0.0";"0.0";"1.0";"0.0";"1.0";"0.0";"1"
"1789303";"Mikhail Kotelnikov";"20";"0";"20";"20";"0";"0";"20";"0";"0";"69";"0.0";"1.0";"1.0";"0.0";"0.0";"1.0";"0.0";"1"
"2264396";"erlvert";"1";"1";"0";"1";"0";"1";"0";"0";"0";"19";"1.0";"0.0";"1.0";"0.0";"1.0";"0.0";"0.0";"1"
"364916";"Vincent de Phily";"1";"1";"0";"0";"1";"0";"0";"1";"0";"1489";"1.0";"0.0";"0.0";"1.0";"0.0";"0.0";"1.0";"1"
"10610";"RedFox";"26";"9";"17";"25";"1";"1";"24";"1";"0";"4422";"0.34615384615384615";"0.6538461538461539";"0.9615384615384616";"0.038461538461538464";"0.038461538461538464";"0.9230769230769231";"0.038461538461538464";"5"
"989564";"Thomas Rast";"3";"3";"0";"0";"3";"1";"2";"0";"0";"181";"1.0";"0.0";"0.0";"1.0";"0.3333333333333333";"0.6666666666666666";"0.0";"2"
"1750383";"Léo Frachet";"32";"0";"32";"32";"0";"26";"6";"0";"0";"147";"0.0";"1.0";"1.0";"0.0";"0.8125";"0.1875";"0.0";"2"
"38262";"Pascal Rigaux";"2";"0";"2";"2";"0";"0";"2";"0";"0";"440";"0.0";"1.0";"1.0";"0.0";"0.0";"1.0";"0.0";"1"
"68982";"kisaa";"7";"1";"6";"6";"1";"1";"3";"3";"0";"2670";"0.14285714285714285";"0.8571428571428571";"0.8571428571428571";"0.14285714285714285";"0.14285714285714285";"0.42857142857142855";"0.42857142857142855";"2"
"86393";"Olivier Delaune";"2";"0";"2";"2";"0";"0";"2";"0";"0";"711";"0.0";"1.0";"1.0";"0.0";"0.0";"1.0";"0.0";"2"
"1709411";"Shlublu";"248";"165";"83";"240";"8";"136";"109";"3";"0";"989";"0.6653225806451613";"0.3346774193548387";"0.967741935483871";"0.03225806451612903";"0.5483870967741935";"0.43951612903225806";"0.012096774193548387";"64"
"90488";"ger4rd";"1";"0";"1";"0";"1";"1";"0";"0";"0";"1960";"0.0";"1.0";"0.0";"1.0";"1.0";"0.0";"0.0";"1"
"521593";"GutsJM";"7";"4";"3";"7";"0";"3";"4";"0";"0";"178";"0.5714285714285714";"0.42857142857142855";"1.0";"0.0";"0.42857142857142855";"0.5714285714285714";"0.0";"6"
"419206";"hmitonneau";"1";"0";"1";"1";"0";"0";"1";"0";"0";"705";"0.0";"1.0";"1.0";"0.0";"0.0";"1.0";"0.0";"1"
"619916";"Olive Rouge";"14";"14";"0";"14";"0";"8";"1";"5";"0";"3";"1.0";"0.0";"1.0";"0.0";"0.5714285714285714";"0.07142857142857142";"0.35714285714285715";"1"
"1994137";"ConwayJ18";"1";"0";"1";"1";"0";"1";"0";"0";"0";"13";"0.0";"1.0";"1.0";"0.0";"1.0";"0.0";"0.0";"1"
"2172329";"yukiandy";"1";"1";"0";"1";"0";"1";"0";"0";"0";"70";"1.0";"0.0";"1.0";"0.0";"1.0";"0.0";"0.0";"1"
"1914263";"Doris de Caraibexpat";"18";"0";"18";"18";"0";"5";"9";"4";"0";"5";"0.0";"1.0";"1.0";"0.0";"0.2777777777777778";"0.5";"0.2222222222222222";"3"
"2512300";"samely";"11";"5";"6";"11";"0";"4";"4";"3";"0";"103656";"0.45454545454545453";"0.5454545454545454";"1.0";"0.0";"0.36363636363636365";"0.36363636363636365";"0.2727272727272727";"4"
"2102700";"Clement_B";"1";"1";"0";"1";"0";"0";"1";"0";"0";"1";"1.0";"0.0";"1.0";"0.0";"0.0";"1.0";"0.0";"1"
"1218972";"kelian8";"4";"2";"2";"2";"2";"0";"4";"0";"0";"247";"0.5";"0.5";"0.5";"0.5";"0.0";"1.0";"0.0";"3"
"1626505";"nk0";"1";"1";"0";"1";"0";"1";"0";"0";"0";"5";"1.0";"0.0";"1.0";"0.0";"1.0";"0.0";"0.0";"1"
"860575";"MarcelHerault";"2073";"1970";"103";"2073";"0";"899";"1105";"69";"0";"11512";"0.9503135552339604";"0.049686444766039554";"1.0";"0.0";"0.43367100820067533";"0.5330438977327545";"0.03328509406657019";"65"
"3119547";"Christophe9791";"1";"0";"1";"0";"1";"1";"0";"0";"0";"43";"0.0";"1.0";"0.0";"1.0";"1.0";"0.0";"0.0";"1"
"2019721";"VinceBugs";"3";"0";"3";"3";"0";"0";"3";"0";"0";"8";"0.0";"1.0";"1.0";"0.0";"0.0";"1.0";"0.0";"3"
"190869";"elbatrop";"2";"2";"0";"2";"0";"1";"1";"0";"0";"5212";"1.0";"0.0";"1.0";"0.0";"0.5";"0.5";"0.0";"2"
"629136";"Stayj";"8";"0";"8";"0";"8";"2";"5";"1";"0";"6";"0.0";"1.0";"0.0";"1.0";"0.25";"0.625";"0.125";"6"
"696723";"Fabienamnet";"9";"0";"9";"0";"9";"9";"0";"0";"0";"320";"0.0";"1.0";"0.0";"1.0";"1.0";"0.0";"0.0";"1"
"52634";"Tristramg";"12";"12";"0";"12";"0";"0";"12";"0";"0";"87";"1.0";"0.0";"1.0";"0.0";"0.0";"1.0";"0.0";"5"
"125339";"efred";"2";"0";"2";"2";"0";"0";"2";"0";"0";"7026";"0.0";"1.0";"1.0";"0.0";"0.0";"1.0";"0.0";"1"
"858513";"ylark";"24";"22";"2";"19";"5";"11";"13";"0";"0";"1441";"0.9166666666666666";"0.08333333333333333";"0.7916666666666666";"0.20833333333333334";"0.4583333333333333";"0.5416666666666666";"0.0";"15"
"538005";"EddieJ";"5";"5";"0";"5";"0";"3";"2";"0";"0";"3029";"1.0";"0.0";"1.0";"0.0";"0.6";"0.4";"0.0";"1"
"1810874";"trystero";"10";"10";"0";"10";"0";"1";"6";"3";"0";"124";"1.0";"0.0";"1.0";"0.0";"0.1";"0.6";"0.3";"5"
"1445303";"Amrik Singh";"1";"0";"1";"1";"0";"1";"0";"0";"0";"1";"0.0";"1.0";"1.0";"0.0";"1.0";"0.0";"0.0";"1"
"577962";"patheticcockroach";"1";"1";"0";"0";"1";"0";"1";"0";"0";"27";"1.0";"0.0";"0.0";"1.0";"0.0";"1.0";"0.0";"1"
"1679807";"Cato_d_Ae";"5";"5";"0";"5";"0";"0";"5";"0";"0";"8281";"1.0";"0.0";"1.0";"0.0";"0.0";"1.0";"0.0";"3"
"214436";"PanierAvide";"8";"0";"8";"8";"0";"0";"8";"0";"1";"3285";"0.0";"1.0";"1.0";"0.0";"0.0";"1.0";"0.0";"1"
"711074";"scm77";"3";"1";"2";"0";"3";"0";"3";"0";"0";"122";"0.3333333333333333";"0.6666666666666666";"0.0";"1.0";"0.0";"1.0";"0.0";"3"
"582049";"yoko99";"2";"0";"2";"2";"0";"0";"2";"0";"0";"5627";"0.0";"1.0";"1.0";"0.0";"0.0";"1.0";"0.0";"1"
"3081605";"emalquier";"1";"0";"1";"1";"0";"0";"1";"0";"0";"44";"0.0";"1.0";"1.0";"0.0";"0.0";"1.0";"0.0";"1"
"2381194";"althio";"52";"47";"5";"52";"0";"12";"40";"0";"0";"617";"0.9038461538461539";"0.09615384615384616";"1.0";"0.0";"0.23076923076923078";"0.7692307692307693";"0.0";"11"
"300459";"didier2020";"3";"2";"1";"1";"2";"1";"2";"0";"1";"36217";"0.6666666666666666";"0.3333333333333333";"0.3333333333333333";"0.6666666666666666";"0.3333333333333333";"0.6666666666666666";"0.0";"3"
"3249566";"Pelléas";"4";"4";"0";"0";"4";"2";"1";"1";"0";"3";"1.0";"0.0";"0.0";"1.0";"0.5";"0.25";"0.25";"1"
"16821";"geraki";"1";"1";"0";"1";"0";"0";"1";"0";"0";"2005";"1.0";"0.0";"1.0";"0.0";"0.0";"1.0";"0.0";"1"
"456113";"eric_G";"154";"154";"0";"154";"0";"0";"55";"99";"0";"8529";"1.0";"0.0";"1.0";"0.0";"0.0";"0.35714285714285715";"0.6428571428571429";"2"
"133564";"axx";"2";"2";"0";"2";"0";"2";"0";"0";"0";"245";"1.0";"0.0";"1.0";"0.0";"1.0";"0.0";"0.0";"1"
"870861";"user_870861";"117";"48";"69";"103";"14";"13";"52";"52";"null";"null";"0.41025641025641024";"0.5897435897435898";"0.8803418803418803";"0.11965811965811966";"0.1111111111111111";"0.4444444444444444";"0.4444444444444444";"21"
"50624";"David Crochet";"2";"2";"0";"1";"1";"0";"1";"1";"0";"4468";"1.0";"0.0";"0.5";"0.5";"0.0";"0.5";"0.5";"2"
"466374";"rando67";"31";"0";"31";"31";"0";"29";"2";"0";"0";"4758";"0.0";"1.0";"1.0";"0.0";"0.9354838709677419";"0.06451612903225806";"0.0";"1"
"3197428";"Carte-on";"19";"19";"0";"0";"19";"0";"19";"0";"0";"199";"1.0";"0.0";"0.0";"1.0";"0.0";"1.0";"0.0";"1"
"644547";"jeremius";"9";"2";"7";"3";"6";"2";"7";"0";"0";"240";"0.2222222222222222";"0.7777777777777778";"0.3333333333333333";"0.6666666666666666";"0.2222222222222222";"0.7777777777777778";"0.0";"4"
"158153";"jetthe";"1";"1";"0";"1";"0";"1";"0";"0";"0";"5022";"1.0";"0.0";"1.0";"0.0";"1.0";"0.0";"0.0";"1"
"2291177";"00u";"1";"0";"1";"1";"0";"1";"0";"0";"0";"192";"0.0";"1.0";"1.0";"0.0";"1.0";"0.0";"0.0";"1"
"2343400";"futing";"1";"0";"1";"1";"0";"1";"0";"0";"0";"2";"0.0";"1.0";"1.0";"0.0";"1.0";"0.0";"0.0";"1"
"2070989";"FlorianPerucchetti";"1";"1";"0";"1";"0";"0";"1";"0";"0";"2482";"1.0";"0.0";"1.0";"0.0";"0.0";"1.0";"0.0";"1"
"1199553";"jean-christophe windland";"60";"0";"60";"43";"17";"15";"40";"5";"0";"63";"0.0";"1.0";"0.7166666666666667";"0.2833333333333333";"0.25";"0.6666666666666666";"0.08333333333333333";"15"
"3289574";"Stella Fashion Europe";"6";"6";"0";"6";"0";"3";"2";"1";"0";"8";"1.0";"0.0";"1.0";"0.0";"0.5";"0.3333333333333333";"0.16666666666666666";"5"
"687570";"FrancoisMallet";"6";"0";"6";"5";"1";"0";"4";"2";"0";"249";"0.0";"1.0";"0.8333333333333334";"0.16666666666666666";"0.0";"0.6666666666666666";"0.3333333333333333";"3"
"598509";"gbilotta";"1";"0";"1";"0";"1";"0";"1";"0";"0";"114";"0.0";"1.0";"0.0";"1.0";"0.0";"1.0";"0.0";"1"
"123364";"Tronikon";"1";"1";"0";"0";"1";"1";"0";"0";"0";"7856";"1.0";"0.0";"0.0";"1.0";"1.0";"0.0";"0.0";"1"
"656876";"Fabus1393";"101";"0";"101";"101";"0";"14";"61";"26";"0";"53";"0.0";"1.0";"1.0";"0.0";"0.13861386138613863";"0.6039603960396039";"0.25742574257425743";"9"
"398817";"ullus";"1";"1";"0";"1";"0";"0";"1";"0";"0";"2145";"1.0";"0.0";"1.0";"0.0";"0.0";"1.0";"0.0";"1"
"1245684";"deloikat";"1";"1";"0";"1";"0";"1";"0";"0";"0";"1";"1.0";"0.0";"1.0";"0.0";"1.0";"0.0";"0.0";"1"
"2749888";"Sovxx";"12";"1";"11";"6";"6";"9";"3";"0";"0";"2359";"0.08333333333333333";"0.9166666666666666";"0.5";"0.5";"0.75";"0.25";"0.0";"6"
"1241595";"ᴀᴅᴍɪɴ";"2";"2";"0";"2";"0";"0";"2";"0";"1";"5428";"1.0";"0.0";"1.0";"0.0";"0.0";"1.0";"0.0";"1"
"860647";"Ljubinka";"1";"0";"1";"1";"0";"0";"1";"0";"0";"292";"0.0";"1.0";"1.0";"0.0";"0.0";"1.0";"0.0";"1"
"76269";"Snusmumriken";"19";"9";"10";"12";"7";"5";"12";"2";"1";"11617";"0.47368421052631576";"0.5263157894736842";"0.631578947368421";"0.3684210526315789";"0.2631578947368421";"0.631578947368421";"0.10526315789473684";"14"
"1016290";"ika-chan! UK";"59";"1";"58";"57";"2";"8";"51";"0";"1";"9132";"0.01694915254237288";"0.9830508474576272";"0.9661016949152542";"0.03389830508474576";"0.13559322033898305";"0.864406779661017";"0.0";"6"
"2762183";"Poluxus";"20";"0";"20";"20";"0";"15";"5";"0";"0";"17";"0.0";"1.0";"1.0";"0.0";"0.75";"0.25";"0.0";"2"
"185836";"sly_bot";"57";"57";"0";"57";"0";"0";"57";"0";"0";"239";"1.0";"0.0";"1.0";"0.0";"0.0";"1.0";"0.0";"3"
"896509";"Cactusbone";"1";"1";"0";"1";"0";"0";"1";"0";"0";"125";"1.0";"0.0";"1.0";"0.0";"0.0";"1.0";"0.0";"1"
"1964526";"louis oblomov";"2";"1";"1";"2";"0";"1";"1";"0";"0";"2";"0.5";"0.5";"1.0";"0.0";"0.5";"0.5";"0.0";"2"
"188930";"JLZIMMERMANN";"129";"99";"30";"115";"14";"77";"51";"1";"0";"41880";"0.7674418604651163";"0.23255813953488372";"0.8914728682170543";"0.10852713178294573";"0.5968992248062015";"0.3953488372093023";"0.007751937984496124";"51"
"1279506";"thibdrev";"4";"1";"3";"4";"0";"0";"4";"0";"0";"4080";"0.25";"0.75";"1.0";"0.0";"0.0";"1.0";"0.0";"2"
"152074";"beweta";"27";"0";"27";"6";"21";"1";"26";"0";"1";"5088";"0.0";"1.0";"0.2222222222222222";"0.7777777777777778";"0.037037037037037035";"0.9629629629629629";"0.0";"4"
"2321975";"MichaeldeParis";"2";"2";"0";"2";"0";"1";"1";"0";"0";"1";"1.0";"0.0";"1.0";"0.0";"0.5";"0.5";"0.0";"1"
"219668";"sev_osm";"25";"5";"20";"20";"5";"17";"7";"1";"0";"5399";"0.2";"0.8";"0.8";"0.2";"0.68";"0.28";"0.04";"4"
"299539";"Lenezir";"2";"2";"0";"2";"0";"0";"2";"0";"1";"907";"1.0";"0.0";"1.0";"0.0";"0.0";"1.0";"0.0";"1"
"212507";"absinthologue";"2";"1";"1";"2";"0";"1";"1";"0";"0";"1700";"0.5";"0.5";"1.0";"0.0";"0.5";"0.5";"0.0";"2"
"79386";"philippekerla";"15";"5";"10";"3";"12";"0";"15";"0";"0";"4630";"0.3333333333333333";"0.6666666666666666";"0.2";"0.8";"0.0";"1.0";"0.0";"9"
"1772032";"Vincent Génin";"8";"8";"0";"8";"0";"0";"8";"0";"0";"707";"1.0";"0.0";"1.0";"0.0";"0.0";"1.0";"0.0";"2"
"1408522";"Omnific";"2";"0";"2";"2";"0";"1";"1";"0";"0";"21282";"0.0";"1.0";"1.0";"0.0";"0.5";"0.5";"0.0";"1"
"1802811";"HalClem";"3";"3";"0";"3";"0";"1";"2";"0";"0";"1525";"1.0";"0.0";"1.0";"0.0";"0.3333333333333333";"0.6666666666666666";"0.0";"3"
"1920573";"Jbenic67";"6";"6";"0";"6";"0";"1";"5";"0";"0";"2";"1.0";"0.0";"1.0";"0.0";"0.16666666666666666";"0.8333333333333334";"0.0";"2"
"76321";"promeneur";"1";"1";"0";"0";"1";"0";"1";"0";"0";"5160";"1.0";"0.0";"0.0";"1.0";"0.0";"1.0";"0.0";"1"
"39457";"Markus59";"3";"3";"0";"0";"3";"0";"3";"0";"0";"7677";"1.0";"0.0";"0.0";"1.0";"0.0";"1.0";"0.0";"3"
"15908";"cantece";"25";"25";"0";"21";"4";"9";"16";"0";"0";"25877";"1.0";"0.0";"0.84";"0.16";"0.36";"0.64";"0.0";"6"
"1702449";"Guide to the Camino";"1";"0";"1";"1";"0";"1";"0";"0";"0";"1";"0.0";"1.0";"1.0";"0.0";"1.0";"0.0";"0.0";"1"
"1598001";"OsmIdf";"114";"74";"40";"90";"24";"13";"100";"1";"0";"746";"0.6491228070175439";"0.3508771929824561";"0.7894736842105263";"0.21052631578947367";"0.11403508771929824";"0.8771929824561403";"0.008771929824561403";"12"
"388649";"Luuuddooo";"11";"4";"7";"11";"0";"5";"6";"0";"0";"2037";"0.36363636363636365";"0.6363636363636364";"1.0";"0.0";"0.45454545454545453";"0.5454545454545454";"0.0";"2"
"2560523";"Robowolfer";"1";"0";"1";"1";"0";"0";"1";"0";"0";"2652";"0.0";"1.0";"1.0";"0.0";"0.0";"1.0";"0.0";"1"
"1011255";"Ano59";"1";"0";"1";"0";"1";"0";"1";"0";"0";"269";"0.0";"1.0";"0.0";"1.0";"0.0";"1.0";"0.0";"1"
"151098";"emm3xx";"2";"0";"2";"2";"0";"0";"2";"0";"0";"25";"0.0";"1.0";"1.0";"0.0";"0.0";"1.0";"0.0";"1"
"2226712";"dannykath";"2";"0";"2";"0";"2";"0";"2";"0";"1";"112070";"0.0";"1.0";"0.0";"1.0";"0.0";"1.0";"0.0";"2"
"143932";"NicolasDumoulin";"2";"2";"0";"2";"0";"0";"2";"0";"0";"3432";"1.0";"0.0";"1.0";"0.0";"0.0";"1.0";"0.0";"1"
"34368";"rschwarz";"1";"0";"1";"1";"0";"1";"0";"0";"0";"734";"0.0";"1.0";"1.0";"0.0";"1.0";"0.0";"0.0";"1"
"248386";"poniol";"1";"1";"0";"1";"0";"0";"1";"0";"0";"5015";"1.0";"0.0";"1.0";"0.0";"0.0";"1.0";"0.0";"1"
"575051";"dkalinine";"1";"1";"0";"1";"0";"0";"1";"0";"0";"315";"1.0";"0.0";"1.0";"0.0";"0.0";"1.0";"0.0";"1"
"2970217";"LICK";"1";"1";"0";"0";"1";"1";"0";"0";"0";"21";"1.0";"0.0";"0.0";"1.0";"1.0";"0.0";"0.0";"1"
"67141";"ligfietser";"1";"0";"1";"1";"0";"1";"0";"0";"0";"10905";"0.0";"1.0";"1.0";"0.0";"1.0";"0.0";"0.0";"1"
"835140";"nounours77";"44";"0";"44";"2";"42";"12";"29";"3";"0";"1314";"0.0";"1.0";"0.045454545454545456";"0.9545454545454546";"0.2727272727272727";"0.6590909090909091";"0.06818181818181818";"9"
"242257";"Emmanuel Dewaele";"41";"5";"36";"29";"12";"9";"31";"1";"0";"1844";"0.12195121951219512";"0.8780487804878049";"0.7073170731707317";"0.2926829268292683";"0.21951219512195122";"0.7560975609756098";"0.024390243902439025";"9"
"368215";"wandsecacher";"1";"0";"1";"1";"0";"0";"1";"0";"0";"7029";"0.0";"1.0";"1.0";"0.0";"0.0";"1.0";"0.0";"1"
"2057798";"Sarvihepo";"6";"0";"6";"6";"0";"0";"6";"0";"0";"3297";"0.0";"1.0";"1.0";"0.0";"0.0";"1.0";"0.0";"2"
"715371";"715371";"1";"1";"0";"1";"0";"0";"1";"0";"0";"8517";"1.0";"0.0";"1.0";"0.0";"0.0";"1.0";"0.0";"1"
"83557";"Esperanza36";"100";"84";"16";"72";"28";"2";"98";"0";"0";"19560";"0.84";"0.16";"0.72";"0.28";"0.02";"0.98";"0.0";"15"
"2544194";"e-bot";"4";"0";"4";"4";"0";"1";"2";"1";"0";"2";"0.0";"1.0";"1.0";"0.0";"0.25";"0.5";"0.25";"2"
"1220214";"Traudi38";"2";"2";"0";"2";"0";"0";"2";"0";"0";"8";"1.0";"0.0";"1.0";"0.0";"0.0";"1.0";"0.0";"1"
"327264";"Vincent Dém";"1";"1";"0";"1";"0";"1";"0";"0";"0";"233";"1.0";"0.0";"1.0";"0.0";"1.0";"0.0";"0.0";"1"
"609900";"Axelos";"2";"2";"0";"2";"0";"1";"1";"0";"0";"1567";"1.0";"0.0";"1.0";"0.0";"0.5";"0.5";"0.0";"1"
"675449";"jseigneuret";"2";"2";"0";"2";"0";"0";"2";"0";"0";"5211";"1.0";"0.0";"1.0";"0.0";"0.0";"1.0";"0.0";"1"
"73334";"Herve5";"3";"1";"2";"0";"3";"3";"0";"0";"0";"332";"0.3333333333333333";"0.6666666666666666";"0.0";"1.0";"1.0";"0.0";"0.0";"2"
"143992";"hackbert";"1";"1";"0";"0";"1";"1";"0";"0";"0";"136";"1.0";"0.0";"0.0";"1.0";"1.0";"0.0";"0.0";"1"
"392827";"pnorman_mechanical";"1";"0";"1";"1";"0";"0";"1";"0";"1";"802";"0.0";"1.0";"1.0";"0.0";"0.0";"1.0";"0.0";"1"
"2377377";"abel801";"4";"3";"1";"4";"0";"0";"3";"1";"0";"68519";"0.75";"0.25";"1.0";"0.0";"0.0";"0.75";"0.25";"2"
"2112166";"Timothée Hoarau";"6";"6";"0";"0";"6";"0";"0";"6";"0";"1";"1.0";"0.0";"0.0";"1.0";"0.0";"0.0";"1.0";"1"
"1964699";"Adrien DORLAND";"2";"2";"0";"2";"0";"0";"2";"0";"0";"1";"1.0";"0.0";"1.0";"0.0";"0.0";"1.0";"0.0";"1"
"64134";"highpotential";"2";"2";"0";"2";"0";"0";"2";"0";"0";"6694";"1.0";"0.0";"1.0";"0.0";"0.0";"1.0";"0.0";"1"
"2280101";"ThisDancerie";"1";"1";"0";"1";"0";"0";"1";"0";"0";"1";"1.0";"0.0";"1.0";"0.0";"0.0";"1.0";"0.0";"1"
"2087571";"Djump";"3";"2";"1";"3";"0";"2";"1";"0";"0";"17";"0.6666666666666666";"0.3333333333333333";"1.0";"0.0";"0.6666666666666666";"0.3333333333333333";"0.0";"3"
"439947";"StephaneP";"16";"0";"16";"16";"0";"0";"16";"0";"1";"6482";"0.0";"1.0";"1.0";"0.0";"0.0";"1.0";"0.0";"1"
"1679";"andrewpmk";"4";"0";"4";"4";"0";"2";"2";"0";"1";"296039";"0.0";"1.0";"1.0";"0.0";"0.5";"0.5";"0.0";"2"
"3334816";"shinodark";"1";"0";"1";"0";"1";"1";"0";"0";"0";"1";"0.0";"1.0";"0.0";"1.0";"1.0";"0.0";"0.0";"1"
"581277";"meihou";"28";"28";"0";"28";"0";"13";"13";"2";"0";"5061";"1.0";"0.0";"1.0";"0.0";"0.4642857142857143";"0.4642857142857143";"0.07142857142857142";"1"
"1244807";"Oberpfälzer";"1";"1";"0";"0";"1";"0";"1";"0";"0";"2728";"1.0";"0.0";"0.0";"1.0";"0.0";"1.0";"0.0";"1"
"18069";"Claudius Henrichs";"1";"0";"1";"0";"1";"0";"1";"0";"0";"20037";"0.0";"1.0";"0.0";"1.0";"0.0";"1.0";"0.0";"1"
"141978";"PhQ";"4";"4";"0";"4";"0";"0";"4";"0";"1";"8220";"1.0";"0.0";"1.0";"0.0";"0.0";"1.0";"0.0";"3"
"1238664";"zerpou";"193";"94";"99";"146";"47";"71";"117";"5";"3";"35029";"0.48704663212435234";"0.5129533678756477";"0.7564766839378239";"0.24352331606217617";"0.36787564766839376";"0.6062176165803109";"0.025906735751295335";"56"
"615059";"misht";"10";"0";"10";"10";"0";"6";"4";"0";"0";"6463";"0.0";"1.0";"1.0";"0.0";"0.6";"0.4";"0.0";"3"
"239256";"erics67";"1";"1";"0";"0";"1";"0";"1";"0";"0";"527";"1.0";"0.0";"0.0";"1.0";"0.0";"1.0";"0.0";"1"
"90780";"Verdy_p";"42";"16";"26";"17";"25";"0";"39";"3";"0";"9050";"0.38095238095238093";"0.6190476190476191";"0.40476190476190477";"0.5952380952380952";"0.0";"0.9285714285714286";"0.07142857142857142";"3"
"136860";"indigomc";"2";"2";"0";"0";"2";"0";"2";"0";"0";"7869";"1.0";"0.0";"0.0";"1.0";"0.0";"1.0";"0.0";"2"
"2407099";"BobOlive";"1";"0";"1";"1";"0";"1";"0";"0";"0";"1";"0.0";"1.0";"1.0";"0.0";"1.0";"0.0";"0.0";"1"
"2027199";"pedroazuram";"5";"0";"5";"5";"0";"3";"2";"0";"0";"2";"0.0";"1.0";"1.0";"0.0";"0.6";"0.4";"0.0";"2"
"2228868";"Singing-poppy_script";"16";"5";"11";"10";"6";"0";"16";"0";"0";"2693";"0.3125";"0.6875";"0.625";"0.375";"0.0";"1.0";"0.0";"16"
"16038";"krysst";"29";"0";"29";"25";"4";"10";"16";"3";"1";"3950";"0.0";"1.0";"0.8620689655172413";"0.13793103448275862";"0.3448275862068966";"0.5517241379310345";"0.10344827586206896";"3"
"399008";"Sam Tuke";"2";"0";"2";"0";"2";"2";"0";"0";"0";"52";"0.0";"1.0";"0.0";"1.0";"1.0";"0.0";"0.0";"1"
"767661";"jmgcmdi14";"42";"42";"0";"6";"36";"18";"14";"10";"0";"7";"1.0";"0.0";"0.14285714285714285";"0.8571428571428571";"0.42857142857142855";"0.3333333333333333";"0.23809523809523808";"3"
"1241781";"shawarma";"8";"8";"0";"8";"0";"4";"3";"1";"0";"167";"1.0";"0.0";"1.0";"0.0";"0.5";"0.375";"0.125";"3"
"550560";"Seandebasti";"1";"0";"1";"1";"0";"0";"1";"0";"0";"7020";"0.0";"1.0";"1.0";"0.0";"0.0";"1.0";"0.0";"1"
"145064";"ebesson";"1";"1";"0";"1";"0";"1";"0";"0";"0";"14";"1.0";"0.0";"1.0";"0.0";"1.0";"0.0";"0.0";"1"
"2053813";"Fang Yuting";"8";"0";"8";"8";"0";"0";"8";"0";"0";"421";"0.0";"1.0";"1.0";"0.0";"0.0";"1.0";"0.0";"1"
"37548";"Marcussacapuces91";"71";"9";"62";"32";"39";"26";"32";"13";"1";"19586";"0.1267605633802817";"0.8732394366197183";"0.4507042253521127";"0.5492957746478874";"0.36619718309859156";"0.4507042253521127";"0.18309859154929578";"7"
"1554107";"jgpacker";"1";"1";"0";"0";"1";"0";"1";"0";"0";"262";"1.0";"0.0";"0.0";"1.0";"0.0";"1.0";"0.0";"1"
"58037";"Bruno Duyé";"1";"1";"0";"1";"0";"1";"0";"0";"0";"346";"1.0";"0.0";"1.0";"0.0";"1.0";"0.0";"0.0";"1"
"338611";"marek kleciak";"21";"21";"0";"21";"0";"5";"16";"0";"2";"16173";"1.0";"0.0";"1.0";"0.0";"0.23809523809523808";"0.7619047619047619";"0.0";"1"
"706229";"JIBEC";"25";"1";"24";"2";"23";"19";"6";"0";"0";"1153";"0.04";"0.96";"0.08";"0.92";"0.76";"0.24";"0.0";"5"
"2034399";"nsat";"3";"3";"0";"3";"0";"1";"2";"0";"0";"3";"1.0";"0.0";"1.0";"0.0";"0.3333333333333333";"0.6666666666666666";"0.0";"3"
"219843";"mides";"4";"4";"0";"3";"1";"0";"4";"0";"1";"17830";"1.0";"0.0";"0.75";"0.25";"0.0";"1.0";"0.0";"4"
"878284";"Benoît Prieur";"4";"4";"0";"4";"0";"1";"3";"0";"0";"8247";"1.0";"0.0";"1.0";"0.0";"0.25";"0.75";"0.0";"4"
"74437";"Mike FABIAN";"2";"2";"0";"0";"2";"1";"1";"0";"0";"5632";"1.0";"0.0";"0.0";"1.0";"0.5";"0.5";"0.0";"2"
"702156";"Kwinkwin";"3";"0";"3";"2";"1";"2";"1";"0";"0";"231";"0.0";"1.0";"0.6666666666666666";"0.3333333333333333";"0.6666666666666666";"0.3333333333333333";"0.0";"3"
"372429";"maxime1986";"13";"13";"0";"6";"7";"1";"12";"0";"0";"118";"1.0";"0.0";"0.46153846153846156";"0.5384615384615384";"0.07692307692307693";"0.9230769230769231";"0.0";"2"
"332493";"bazgal";"8";"7";"1";"1";"7";"0";"8";"0";"0";"7993";"0.875";"0.125";"0.125";"0.875";"0.0";"1.0";"0.0";"2"
"1500895";"joobe";"1";"1";"0";"1";"0";"1";"0";"0";"0";"2";"1.0";"0.0";"1.0";"0.0";"1.0";"0.0";"0.0";"1"
"53964";"_Mathieu_";"185";"83";"102";"84";"101";"56";"109";"20";"0";"3033";"0.4486486486486487";"0.5513513513513514";"0.4540540540540541";"0.5459459459459459";"0.3027027027027027";"0.5891891891891892";"0.10810810810810811";"20"
"167634";"ab_fab";"6";"5";"1";"5";"1";"0";"2";"4";"0";"913";"0.8333333333333334";"0.16666666666666666";"0.8333333333333334";"0.16666666666666666";"0.0";"0.3333333333333333";"0.6666666666666666";"2"
"3349216";"Monica Godi";"3";"0";"3";"3";"0";"0";"3";"0";"0";"4";"0.0";"1.0";"1.0";"0.0";"0.0";"1.0";"0.0";"1"
"3303148";"Insaf";"11";"0";"11";"11";"0";"6";"5";"0";"0";"1";"0.0";"1.0";"1.0";"0.0";"0.5454545454545454";"0.45454545454545453";"0.0";"1"
"365274";"thbz";"2948";"1524";"1424";"939";"2009";"1212";"1639";"97";"0";"3645";"0.5169606512890095";"0.4830393487109905";"0.3185210312075984";"0.6814789687924017";"0.41112618724559025";"0.5559701492537313";"0.03290366350067843";"179"
"1862339";"Pierre Beyssac";"48";"44";"4";"45";"3";"14";"22";"12";"0";"1436";"0.9166666666666666";"0.08333333333333333";"0.9375";"0.0625";"0.2916666666666667";"0.4583333333333333";"0.25";"4"
"2472647";"Darthevel";"1";"0";"1";"0";"1";"1";"0";"0";"0";"18";"0.0";"1.0";"0.0";"1.0";"1.0";"0.0";"0.0";"1"
"433893";"teymour";"2";"2";"0";"2";"0";"1";"1";"0";"0";"63";"1.0";"0.0";"1.0";"0.0";"0.5";"0.5";"0.0";"2"
"1467125";"mathurin petit";"5";"5";"0";"5";"0";"5";"0";"0";"0";"1";"1.0";"0.0";"1.0";"0.0";"1.0";"0.0";"0.0";"1"
"1903358";"un signifiant";"1";"0";"1";"0";"1";"0";"1";"0";"0";"1";"0.0";"1.0";"0.0";"1.0";"0.0";"1.0";"0.0";"1"
"1519347";"Hicio";"2";"2";"0";"2";"0";"0";"1";"1";"0";"3";"1.0";"0.0";"1.0";"0.0";"0.0";"0.5";"0.5";"1"
"3020487";"Thomasismapping";"39";"3";"36";"39";"0";"4";"34";"1";"0";"51";"0.07692307692307693";"0.9230769230769231";"1.0";"0.0";"0.10256410256410256";"0.8717948717948718";"0.02564102564102564";"10"
"1556219";"Thibaut75011";"420";"328";"92";"312";"108";"208";"165";"47";"0";"4260";"0.780952380952381";"0.21904761904761905";"0.7428571428571429";"0.2571428571428571";"0.49523809523809526";"0.39285714285714285";"0.11190476190476191";"164"
"2179792";"SeFaireConnaitre";"7";"7";"0";"7";"0";"4";"3";"0";"3";"22431";"1.0";"0.0";"1.0";"0.0";"0.5714285714285714";"0.42857142857142855";"0.0";"7"
"1217251";"lolotolosa";"1";"0";"1";"0";"1";"0";"1";"0";"0";"118";"0.0";"1.0";"0.0";"1.0";"0.0";"1.0";"0.0";"1"
"107257";"FrViPofm";"11";"11";"0";"11";"0";"0";"11";"0";"2";"7407";"1.0";"0.0";"1.0";"0.0";"0.0";"1.0";"0.0";"2"
"1267435";"Glop";"1";"0";"1";"1";"0";"0";"1";"0";"0";"1";"0.0";"1.0";"1.0";"0.0";"0.0";"1.0";"0.0";"1"
"1939231";"Charles Outters";"1";"0";"1";"1";"0";"0";"1";"0";"0";"186";"0.0";"1.0";"1.0";"0.0";"0.0";"1.0";"0.0";"1"
"1075986";"the_knife";"1";"0";"1";"1";"0";"1";"0";"0";"0";"12561";"0.0";"1.0";"1.0";"0.0";"1.0";"0.0";"0.0";"1"
"2818856";"CitymapperHQ";"1";"1";"0";"1";"0";"0";"1";"0";"0";"2437";"1.0";"0.0";"1.0";"0.0";"0.0";"1.0";"0.0";"1"
"317197";"kpouer";"5";"5";"0";"5";"0";"3";"2";"0";"0";"1152";"1.0";"0.0";"1.0";"0.0";"0.6";"0.4";"0.0";"1"
"2748195";"karitotp";"1";"1";"0";"1";"0";"0";"1";"0";"0";"99871";"1.0";"0.0";"1.0";"0.0";"0.0";"1.0";"0.0";"1"
"933635";"felixjar";"1";"1";"0";"1";"0";"1";"0";"0";"0";"5";"1.0";"0.0";"1.0";"0.0";"1.0";"0.0";"0.0";"1"
"904963";"ty000";"5";"5";"0";"5";"0";"1";"1";"3";"0";"194";"1.0";"0.0";"1.0";"0.0";"0.2";"0.2";"0.6";"1"
"2814778";"VinceBot";"2237";"0";"2237";"2237";"0";"0";"2237";"0";"0";"184";"0.0";"1.0";"1.0";"0.0";"0.0";"1.0";"0.0";"49"
"492311";"zacmccormick";"2";"0";"2";"0";"2";"0";"2";"0";"0";"2784";"0.0";"1.0";"0.0";"1.0";"0.0";"1.0";"0.0";"1"
"158481";"Tanguy Ortolo";"3";"3";"0";"3";"0";"0";"3";"0";"0";"107";"1.0";"0.0";"1.0";"0.0";"0.0";"1.0";"0.0";"1"
"1919754";"Lbrunet_com";"5";"5";"0";"5";"0";"4";"1";"0";"0";"1";"1.0";"0.0";"1.0";"0.0";"0.8";"0.2";"0.0";"1"
"129818";"jrouquie";"4";"4";"0";"0";"4";"0";"3";"1";"0";"348";"1.0";"0.0";"0.0";"1.0";"0.0";"0.75";"0.25";"1"
"2117436";"GInkgo67000";"16";"1";"15";"0";"16";"7";"4";"5";"0";"77";"0.0625";"0.9375";"0.0";"1.0";"0.4375";"0.25";"0.3125";"5"
"396059";"bartvm";"5";"0";"5";"0";"5";"0";"5";"0";"0";"7";"0.0";"1.0";"0.0";"1.0";"0.0";"1.0";"0.0";"3"
"57126";"yxoc";"236";"71";"165";"183";"53";"120";"115";"1";"0";"7853";"0.3008474576271186";"0.6991525423728814";"0.7754237288135594";"0.2245762711864407";"0.5084745762711864";"0.4872881355932203";"0.00423728813559322";"47"
"382765";"exe";"1";"1";"0";"1";"0";"0";"1";"0";"0";"380";"1.0";"0.0";"1.0";"0.0";"0.0";"1.0";"0.0";"1"
"176936";"Poteannee";"5";"1";"4";"5";"0";"3";"2";"0";"0";"170";"0.2";"0.8";"1.0";"0.0";"0.6";"0.4";"0.0";"4"
"3083013";"Sukkoria";"1";"1";"0";"1";"0";"1";"0";"0";"0";"352";"1.0";"0.0";"1.0";"0.0";"1.0";"0.0";"0.0";"1"
"973600";"eBin";"2";"0";"2";"2";"0";"0";"2";"0";"0";"1400";"0.0";"1.0";"1.0";"0.0";"0.0";"1.0";"0.0";"1"
"2204433";"Heinosa";"5";"3";"2";"4";"1";"1";"4";"0";"0";"181";"0.6";"0.4";"0.8";"0.2";"0.2";"0.8";"0.0";"4"
"2853656";"adrien-j";"8";"8";"0";"8";"0";"2";"6";"0";"0";"45";"1.0";"0.0";"1.0";"0.0";"0.25";"0.75";"0.0";"8"
"53048";"jfnif";"1";"1";"0";"1";"0";"0";"0";"1";"0";"12102";"1.0";"0.0";"1.0";"0.0";"0.0";"0.0";"1.0";"1"
"2809619";"KevinCCI";"13";"13";"0";"13";"0";"9";"4";"0";"0";"21";"1.0";"0.0";"1.0";"0.0";"0.6923076923076923";"0.3076923076923077";"0.0";"1"
"685878";"Plop76";"2";"2";"0";"0";"2";"0";"2";"0";"1";"1986";"1.0";"0.0";"0.0";"1.0";"0.0";"1.0";"0.0";"2"
"11068";"windu2b";"1";"1";"0";"1";"0";"1";"0";"0";"0";"3188";"1.0";"0.0";"1.0";"0.0";"1.0";"0.0";"0.0";"1"
"1866529";"kort-to-osm";"7";"3";"4";"7";"0";"0";"7";"0";"0";"935";"0.42857142857142855";"0.5714285714285714";"1.0";"0.0";"0.0";"1.0";"0.0";"7"
"27454";"Popolon";"217";"143";"74";"196";"21";"112";"98";"7";"0";"5460";"0.6589861751152074";"0.34101382488479265";"0.9032258064516129";"0.0967741935483871";"0.5161290322580645";"0.45161290322580644";"0.03225806451612903";"33"
"2475803";"AnHar0033";"3";"3";"0";"3";"0";"0";"3";"0";"0";"2";"1.0";"0.0";"1.0";"0.0";"0.0";"1.0";"0.0";"2"
"78656";"Walter Schlögl";"4";"2";"2";"1";"3";"0";"4";"0";"0";"65817";"0.5";"0.5";"0.25";"0.75";"0.0";"1.0";"0.0";"3"
"505667";"Bullroarer";"2";"0";"2";"2";"0";"2";"0";"0";"0";"3927";"0.0";"1.0";"1.0";"0.0";"1.0";"0.0";"0.0";"1"
"213831";"Josef73";"1";"1";"0";"0";"1";"0";"1";"0";"0";"8564";"1.0";"0.0";"0.0";"1.0";"0.0";"1.0";"0.0";"1"
"138059";"Truchin";"355";"217";"138";"229";"126";"150";"114";"91";"0";"11596";"0.6112676056338028";"0.38873239436619716";"0.6450704225352113";"0.35492957746478876";"0.4225352112676056";"0.3211267605633803";"0.2563380281690141";"41"
"145231";"woodpeck_repair";"8";"5";"3";"3";"5";"0";"8";"0";"0";"2169";"0.625";"0.375";"0.375";"0.625";"0.0";"1.0";"0.0";"3"
"3297149";"3errie";"1";"1";"0";"1";"0";"1";"0";"0";"0";"1";"1.0";"0.0";"1.0";"0.0";"1.0";"0.0";"0.0";"1"
"1154880";"AntonBryl";"20";"20";"0";"20";"0";"8";"11";"1";"0";"213";"1.0";"0.0";"1.0";"0.0";"0.4";"0.55";"0.05";"3"
"161619";"FvGordon";"10";"0";"10";"10";"0";"2";"7";"1";"0";"105488";"0.0";"1.0";"1.0";"0.0";"0.2";"0.7";"0.1";"3"
"1878856";"yourealwaysbe";"141";"6";"135";"135";"6";"68";"73";"0";"0";"2919";"0.0425531914893617";"0.9574468085106383";"0.9574468085106383";"0.0425531914893617";"0.48226950354609927";"0.5177304964539007";"0.0";"10"
"704348";"JBacc1";"31";"16";"15";"27";"4";"18";"13";"0";"0";"3279";"0.5161290322580645";"0.4838709677419355";"0.8709677419354839";"0.12903225806451613";"0.5806451612903226";"0.41935483870967744";"0.0";"13"
"66391";"geozeisig";"9";"9";"0";"9";"0";"0";"9";"0";"2";"14674";"1.0";"0.0";"1.0";"0.0";"0.0";"1.0";"0.0";"1"
"1951562";"jopasserat";"1";"1";"0";"1";"0";"1";"0";"0";"0";"47";"1.0";"0.0";"1.0";"0.0";"1.0";"0.0";"0.0";"1"
"1490806";"stillman";"1";"0";"1";"1";"0";"0";"1";"0";"0";"1";"0.0";"1.0";"1.0";"0.0";"0.0";"1.0";"0.0";"1"
"1701759";"Anakin1976";"1";"0";"1";"1";"0";"0";"1";"0";"0";"3137";"0.0";"1.0";"1.0";"0.0";"0.0";"1.0";"0.0";"1"
"2771789";"Ufal";"30";"0";"30";"5";"25";"2";"27";"1";"0";"562";"0.0";"1.0";"0.16666666666666666";"0.8333333333333334";"0.06666666666666667";"0.9";"0.03333333333333333";"11"
"2170694";"Cemeke Pirketou";"1";"0";"1";"1";"0";"0";"1";"0";"0";"1";"0.0";"1.0";"1.0";"0.0";"0.0";"1.0";"0.0";"1"
"47978";"Christoph Lotz";"67";"67";"0";"67";"0";"0";"67";"0";"0";"3959";"1.0";"0.0";"1.0";"0.0";"0.0";"1.0";"0.0";"1"
"2405193";"Guimoz";"1";"0";"1";"1";"0";"0";"1";"0";"0";"48";"0.0";"1.0";"1.0";"0.0";"0.0";"1.0";"0.0";"1"
"1292156";"Nicholas14";"9";"0";"9";"9";"0";"0";"9";"0";"0";"2";"0.0";"1.0";"1.0";"0.0";"0.0";"1.0";"0.0";"1"
"2520918";"kendyshuai";"1";"0";"1";"0";"1";"1";"0";"0";"0";"1";"0.0";"1.0";"0.0";"1.0";"1.0";"0.0";"0.0";"1"
"1438567";"Dani91";"1";"0";"1";"0";"1";"1";"0";"0";"0";"242";"0.0";"1.0";"0.0";"1.0";"1.0";"0.0";"0.0";"1"
"24440";"jaakkoh";"4";"4";"0";"4";"0";"1";"3";"0";"0";"3459";"1.0";"0.0";"1.0";"0.0";"0.25";"0.75";"0.0";"1"
"41851";"remyoudompheng";"12";"0";"12";"12";"0";"11";"1";"0";"0";"538";"0.0";"1.0";"1.0";"0.0";"0.9166666666666666";"0.08333333333333333";"0.0";"1"
"290680";"wheelmap_visitor";"28";"19";"9";"23";"5";"0";"28";"0";"0";"22158";"0.6785714285714286";"0.32142857142857145";"0.8214285714285714";"0.17857142857142858";"0.0";"1.0";"0.0";"17"
"47996";"Poussah";"12";"12";"0";"12";"0";"5";"6";"1";"0";"46";"1.0";"0.0";"1.0";"0.0";"0.4166666666666667";"0.5";"0.08333333333333333";"1"
"2511706";"calfarome";"2";"0";"2";"2";"0";"0";"2";"0";"0";"121142";"0.0";"1.0";"1.0";"0.0";"0.0";"1.0";"0.0";"2"
"2253663";"Bricou";"2";"0";"2";"2";"0";"2";"0";"0";"0";"2";"0.0";"1.0";"1.0";"0.0";"1.0";"0.0";"0.0";"2"
"2091874";"gui11aume";"1";"0";"1";"1";"0";"0";"1";"0";"0";"155";"0.0";"1.0";"1.0";"0.0";"0.0";"1.0";"0.0";"1"
"38784";"Tom Morris";"20";"16";"4";"5";"15";"3";"17";"0";"0";"4223";"0.8";"0.2";"0.25";"0.75";"0.15";"0.85";"0.0";"19"
"2817961";"WARN";"1";"1";"0";"0";"1";"1";"0";"0";"0";"1";"1.0";"0.0";"0.0";"1.0";"1.0";"0.0";"0.0";"1"
"451458";"Kvardek du";"1";"1";"0";"0";"1";"0";"1";"0";"0";"229";"1.0";"0.0";"0.0";"1.0";"0.0";"1.0";"0.0";"1"
"1752991";"Phil2059";"2";"2";"0";"0";"2";"1";"1";"0";"0";"17";"1.0";"0.0";"0.0";"1.0";"0.5";"0.5";"0.0";"2"
"17286";"Pieren";"22";"1";"21";"22";"0";"0";"16";"6";"0";"9463";"0.045454545454545456";"0.9545454545454546";"1.0";"0.0";"0.0";"0.7272727272727273";"0.2727272727272727";"4"
"1098648";"gsperb";"3";"2";"1";"2";"1";"1";"2";"0";"0";"28546";"0.6666666666666666";"0.3333333333333333";"0.6666666666666666";"0.3333333333333333";"0.3333333333333333";"0.6666666666666666";"0.0";"3"
"1418137";"Test360";"7";"1";"6";"7";"0";"0";"7";"0";"0";"18692";"0.14285714285714285";"0.8571428571428571";"1.0";"0.0";"0.0";"1.0";"0.0";"5"
"181135";"Manu1400";"23";"8";"15";"20";"3";"0";"22";"1";"1";"7651";"0.34782608695652173";"0.6521739130434783";"0.8695652173913043";"0.13043478260869565";"0.0";"0.9565217391304348";"0.043478260869565216";"18"
"566149";"Zolo";"22";"22";"0";"17";"5";"0";"22";"0";"0";"73";"1.0";"0.0";"0.7727272727272727";"0.22727272727272727";"0.0";"1.0";"0.0";"7"
"1247132";"csrhodes";"1";"1";"0";"0";"1";"1";"0";"0";"0";"19";"1.0";"0.0";"0.0";"1.0";"1.0";"0.0";"0.0";"1"
"2519989";"Karl911";"3";"3";"0";"0";"3";"1";"2";"0";"0";"2";"1.0";"0.0";"0.0";"1.0";"0.3333333333333333";"0.6666666666666666";"0.0";"2"
"149398";"civitano";"6";"0";"6";"6";"0";"2";"3";"1";"0";"1470";"0.0";"1.0";"1.0";"0.0";"0.3333333333333333";"0.5";"0.16666666666666666";"1"
"651165";"feuerbach78";"1";"0";"1";"1";"0";"0";"1";"0";"0";"616";"0.0";"1.0";"1.0";"0.0";"0.0";"1.0";"0.0";"1"
"287632";"Alexis de Lattre";"2";"0";"2";"2";"0";"2";"0";"0";"0";"213";"0.0";"1.0";"1.0";"0.0";"1.0";"0.0";"0.0";"1"
"2322358";"JanineLip6";"4";"4";"0";"4";"0";"4";"0";"0";"0";"2";"1.0";"0.0";"1.0";"0.0";"1.0";"0.0";"0.0";"1"
"49047";"vincent_95";"39";"27";"12";"11";"28";"26";"13";"0";"0";"16864";"0.6923076923076923";"0.3076923076923077";"0.28205128205128205";"0.717948717948718";"0.6666666666666666";"0.3333333333333333";"0.0";"9"
"1848197";"Ludovic Paire";"1";"1";"0";"1";"0";"1";"0";"0";"0";"31";"1.0";"0.0";"1.0";"0.0";"1.0";"0.0";"0.0";"1"
"1779584";"dhuyp";"3553";"2740";"813";"3190";"363";"2667";"838";"48";"0";"1409";"0.7711792851111736";"0.22882071488882635";"0.8978328173374613";"0.1021671826625387";"0.7506332676611315";"0.2358570222347312";"0.01350971010413735";"71"
"384920";"zewan";"18";"18";"0";"18";"0";"12";"5";"1";"0";"1072";"1.0";"0.0";"1.0";"0.0";"0.6666666666666666";"0.2777777777777778";"0.05555555555555555";"1"
"2556857";"pierre-ogier urvoi";"9";"9";"0";"9";"0";"9";"0";"0";"0";"6";"1.0";"0.0";"1.0";"0.0";"1.0";"0.0";"0.0";"4"
"105379";"Ludman";"1";"1";"0";"1";"0";"0";"1";"0";"0";"600";"1.0";"0.0";"1.0";"0.0";"0.0";"1.0";"0.0";"1"
"2130818";"tfig";"1";"0";"1";"1";"0";"1";"0";"0";"0";"1";"0.0";"1.0";"1.0";"0.0";"1.0";"0.0";"0.0";"1"
"1136564";"cafecho";"12";"0";"12";"12";"0";"1";"11";"0";"0";"2652";"0.0";"1.0";"1.0";"0.0";"0.08333333333333333";"0.9166666666666666";"0.0";"1"
"332704";"Papou";"1";"0";"1";"1";"0";"0";"1";"0";"0";"2407";"0.0";"1.0";"1.0";"0.0";"0.0";"1.0";"0.0";"1"
"2010038";"gpsnail";"1";"1";"0";"1";"0";"0";"1";"0";"0";"7";"1.0";"0.0";"1.0";"0.0";"0.0";"1.0";"0.0";"1"
"92075";"Art Penteur";"28";"0";"28";"28";"0";"0";"28";"0";"0";"11910";"0.0";"1.0";"1.0";"0.0";"0.0";"1.0";"0.0";"2"
"1151930";"Ludovic Drouard";"12";"0";"12";"0";"12";"2";"9";"1";"0";"7126";"0.0";"1.0";"0.0";"1.0";"0.16666666666666666";"0.75";"0.08333333333333333";"1"
"2001840";"Kартографов";"1";"1";"0";"1";"0";"0";"1";"0";"0";"199";"1.0";"0.0";"1.0";"0.0";"0.0";"1.0";"0.0";"1"
"355242";"Bryce C Nesbitt";"50";"0";"50";"50";"0";"0";"50";"0";"0";"1928";"0.0";"1.0";"1.0";"0.0";"0.0";"1.0";"0.0";"1"
"1044414";"Guillaume Castagnino";"27";"0";"27";"27";"0";"0";"25";"2";"0";"703";"0.0";"1.0";"1.0";"0.0";"0.0";"0.9259259259259259";"0.07407407407407407";"1"
"1093541";"NicolasBertolissio";"10";"0";"10";"1";"9";"6";"4";"0";"0";"104";"0.0";"1.0";"0.1";"0.9";"0.6";"0.4";"0.0";"5"
"2039721";"Michel Tapis";"4";"4";"0";"0";"4";"3";"1";"0";"0";"3";"1.0";"0.0";"0.0";"1.0";"0.75";"0.25";"0.0";"3"
"691133";"Shohreh";"10";"9";"1";"10";"0";"9";"1";"0";"0";"960";"0.9";"0.1";"1.0";"0.0";"0.9";"0.1";"0.0";"3"
"2798481";"GionUait";"1";"1";"0";"1";"0";"0";"1";"0";"0";"28";"1.0";"0.0";"1.0";"0.0";"0.0";"1.0";"0.0";"1"
"68540";"paracetamolo";"15";"9";"6";"9";"6";"8";"6";"1";"0";"1624";"0.6";"0.4";"0.6";"0.4";"0.5333333333333333";"0.4";"0.06666666666666667";"15"
"208829";"Géovélo";"191";"169";"22";"74";"117";"12";"179";"0";"0";"18181";"0.8848167539267016";"0.11518324607329843";"0.387434554973822";"0.612565445026178";"0.06282722513089005";"0.93717277486911";"0.0";"28"
"1969056";"Julien Villeneuve";"10";"10";"0";"10";"0";"7";"3";"0";"0";"27";"1.0";"0.0";"1.0";"0.0";"0.7";"0.3";"0.0";"7"
"139202";"mihof";"1";"0";"1";"1";"0";"0";"1";"0";"0";"4518";"0.0";"1.0";"1.0";"0.0";"0.0";"1.0";"0.0";"1"
"1448918";"Phil_Traere";"1";"0";"1";"0";"1";"1";"0";"0";"0";"129";"0.0";"1.0";"0.0";"1.0";"1.0";"0.0";"0.0";"1"
"125897";"overflorian";"7";"7";"0";"7";"0";"1";"6";"0";"0";"6225";"1.0";"0.0";"1.0";"0.0";"0.14285714285714285";"0.8571428571428571";"0.0";"5"
"598976";"Eolas";"5";"0";"5";"5";"0";"3";"2";"0";"0";"8";"0.0";"1.0";"1.0";"0.0";"0.6";"0.4";"0.0";"2"
"1085404";"z0ltan";"1";"1";"0";"1";"0";"0";"1";"0";"0";"29";"1.0";"0.0";"1.0";"0.0";"0.0";"1.0";"0.0";"1"
"150478";"Coyau";"1";"0";"1";"1";"0";"0";"1";"0";"0";"518";"0.0";"1.0";"1.0";"0.0";"0.0";"1.0";"0.0";"1"
"324552";"Fabimaru";"2";"0";"2";"2";"0";"0";"2";"0";"0";"1018";"0.0";"1.0";"1.0";"0.0";"0.0";"1.0";"0.0";"1"
"1372123";"Pierre Toulouse";"7";"7";"0";"7";"0";"7";"0";"0";"0";"2";"1.0";"0.0";"1.0";"0.0";"1.0";"0.0";"0.0";"2"
"533465";"GerdP";"1";"1";"0";"1";"0";"0";"1";"0";"0";"11933";"1.0";"0.0";"1.0";"0.0";"0.0";"1.0";"0.0";"1"
"120784";"Jor63";"2";"2";"0";"0";"2";"0";"2";"0";"0";"288";"1.0";"0.0";"0.0";"1.0";"0.0";"1.0";"0.0";"2"
"1668042";"Sabama";"2";"2";"0";"2";"0";"2";"0";"0";"0";"21";"1.0";"0.0";"1.0";"0.0";"1.0";"0.0";"0.0";"1"
"2772976";"bot_gileri";"13";"0";"13";"0";"13";"0";"13";"0";"0";"17";"0.0";"1.0";"0.0";"1.0";"0.0";"1.0";"0.0";"2"
"19418";"JonathanMM";"1";"1";"0";"1";"0";"0";"1";"0";"0";"529";"1.0";"0.0";"1.0";"0.0";"0.0";"1.0";"0.0";"1"
"309210";"Jepau";"1";"0";"1";"1";"0";"0";"1";"0";"0";"3652";"0.0";"1.0";"1.0";"0.0";"0.0";"1.0";"0.0";"1"
"1486839";"ypid";"3";"0";"3";"3";"0";"0";"3";"0";"0";"418";"0.0";"1.0";"1.0";"0.0";"0.0";"1.0";"0.0";"2"
"1246193";"aymericdj";"2";"2";"0";"0";"2";"1";"1";"0";"0";"1";"1.0";"0.0";"0.0";"1.0";"0.5";"0.5";"0.0";"1"
"20450";"BerndS";"2";"0";"2";"1";"1";"1";"1";"0";"0";"75";"0.0";"1.0";"0.5";"0.5";"0.5";"0.5";"0.0";"2"
"2159558";"sdever";"7";"7";"0";"0";"7";"0";"7";"0";"0";"78";"1.0";"0.0";"0.0";"1.0";"0.0";"1.0";"0.0";"1"
"1198074";"DoubleA";"22";"0";"22";"22";"0";"7";"14";"1";"1";"9959";"0.0";"1.0";"1.0";"0.0";"0.3181818181818182";"0.6363636363636364";"0.045454545454545456";"3"
"2887620";"keumaR";"9";"7";"2";"7";"2";"2";"7";"0";"0";"8";"0.7777777777777778";"0.2222222222222222";"0.7777777777777778";"0.2222222222222222";"0.2222222222222222";"0.7777777777777778";"0.0";"6"
"1668080";"gsimon";"13";"7";"6";"7";"6";"1";"11";"1";"0";"6173";"0.5384615384615384";"0.46153846153846156";"0.5384615384615384";"0.46153846153846156";"0.07692307692307693";"0.8461538461538461";"0.07692307692307693";"10"
"2362317";"carti";"1";"0";"1";"0";"1";"0";"1";"0";"0";"5";"0.0";"1.0";"0.0";"1.0";"0.0";"1.0";"0.0";"1"
"947168";"La Souris Verte";"1";"1";"0";"0";"1";"0";"1";"0";"0";"11";"1.0";"0.0";"0.0";"1.0";"0.0";"1.0";"0.0";"1"
"2219985";"ethelmermaid";"3";"0";"3";"3";"0";"1";"2";"0";"0";"414";"0.0";"1.0";"1.0";"0.0";"0.3333333333333333";"0.6666666666666666";"0.0";"1"
"1702891";"Rylo";"1";"1";"0";"1";"0";"1";"0";"0";"0";"5";"1.0";"0.0";"1.0";"0.0";"1.0";"0.0";"0.0";"1"
"394224";"Tzafrir Cohen";"1";"0";"1";"0";"1";"0";"1";"0";"0";"195";"0.0";"1.0";"0.0";"1.0";"0.0";"1.0";"0.0";"1"
"400383";"Kalaallit Nunaat";"28";"22";"6";"10";"18";"18";"10";"0";"0";"21755";"0.7857142857142857";"0.21428571428571427";"0.35714285714285715";"0.6428571428571429";"0.6428571428571429";"0.35714285714285715";"0.0";"5"
"238584";"mcld";"2";"1";"1";"2";"0";"2";"0";"0";"0";"3736";"0.5";"0.5";"1.0";"0.0";"1.0";"0.0";"0.0";"2"
"692215";"benouville";"29";"8";"21";"10";"19";"14";"15";"0";"0";"2395";"0.27586206896551724";"0.7241379310344828";"0.3448275862068966";"0.6551724137931034";"0.4827586206896552";"0.5172413793103449";"0.0";"25"
