"uid";"name";"nbContributions";"nbDayContributions";"nbNightContributions";"nbOfweekContributions";"nbOfweekendContributions";"nbCreations";"nbModifications";"nbDeletes";"nbBlockReceived";"totalChangesetCount";"p_DayContributions";"p_NightContributions";"p_OfweekContributions";"p_OfweekendContributions";"p_Creations";"p_Modifications";"p_Deletes";"nbChangesetFenetre"
"4980813";"sambal chaulagain";"2";"0";"2";"0";"2";"1";"1";"0";"null";"null";"0.0";"1.0";"0.0";"1.0";"0.5";"0.5";"0.0";"2"
"2875433";"JoeSteele11";"12";"0";"12";"11";"1";"8";"4";"0";"null";"null";"0.0";"1.0";"0.9166666666666666";"0.08333333333333333";"0.6666666666666666";"0.3333333333333333";"0.0";"2"
"4886607";"Di Pesh JuNg ThaKuri";"1";"0";"1";"0";"1";"1";"0";"0";"null";"null";"0.0";"1.0";"0.0";"1.0";"1.0";"0.0";"0.0";"1"
"4259908";"Andrew Yoak";"3";"2";"1";"2";"1";"0";"3";"3";"null";"null";"0.6666666666666666";"0.3333333333333333";"0.6666666666666666";"0.3333333333333333";"0.0";"1.0";"1.0";"1"
"2859052";"Zito_V";"576";"0";"576";"575";"1";"155";"421";"6";"null";"null";"0.0";"1.0";"0.9982638888888888";"0.001736111111111111";"0.2690972222222222";"0.7309027777777778";"0.010416666666666666";"1"
"2867235";"earkison08";"71";"70";"1";"70";"1";"71";"0";"0";"null";"null";"0.9859154929577465";"0.014084507042253521";"0.9859154929577465";"0.014084507042253521";"1.0";"0.0";"0.0";"2"
"3342394";"ashis07";"40";"39";"1";"39";"1";"16";"24";"1";"null";"null";"0.975";"0.025";"0.975";"0.025";"0.4";"0.6";"0.025";"3"
"4111";"adenium";"526";"0";"526";"525";"1";"518";"8";"0";"null";"null";"0.0";"1.0";"0.9980988593155894";"0.0019011406844106464";"0.9847908745247148";"0.015209125475285171";"0.0";"6"
"471063";"kritagya";"4";"3";"1";"3";"1";"2";"2";"1";"null";"null";"0.75";"0.25";"0.75";"0.25";"0.5";"0.5";"0.25";"1"
"2879547";"julien8234";"26";"0";"26";"25";"1";"26";"0";"0";"null";"null";"0.0";"1.0";"0.9615384615384616";"0.038461538461538464";"1.0";"0.0";"0.0";"1"
"4485206";"Damien En Rit";"2";"0";"2";"1";"1";"2";"0";"0";"null";"null";"0.0";"1.0";"0.5";"0.5";"1.0";"0.0";"0.0";"2"
"311318";"luiswoo";"20";"0";"20";"19";"1";"16";"4";"0";"null";"null";"0.0";"1.0";"0.95";"0.05";"0.8";"0.2";"0.0";"1"
"385046";"Palolo";"10";"0";"10";"9";"1";"10";"0";"0";"null";"null";"0.0";"1.0";"0.9";"0.1";"1.0";"0.0";"0.0";"1"
"1703949";"Guy Maurel KONAN";"8";"0";"8";"0";"8";"8";"0";"0";"null";"null";"0.0";"1.0";"0.0";"1.0";"1.0";"0.0";"0.0";"2"
"3395627";"yogesh10446";"23";"2";"21";"19";"4";"21";"2";"0";"null";"null";"0.08695652173913043";"0.9130434782608695";"0.8260869565217391";"0.17391304347826086";"0.9130434782608695";"0.08695652173913043";"0.0";"8"
"4726865";"Outshine Adventure Pvt Ltd";"1";"0";"1";"0";"1";"1";"0";"0";"null";"null";"0.0";"1.0";"0.0";"1.0";"1.0";"0.0";"0.0";"1"
"3215407";"Sandeep Raj Shakya";"6";"0";"6";"0";"6";"6";"0";"0";"null";"null";"0.0";"1.0";"0.0";"1.0";"1.0";"0.0";"0.0";"1"
"172061";"CloCkWeRX";"4827";"3282";"1545";"3035";"1792";"544";"4283";"1873";"null";"null";"0.6799254195152269";"0.32007458048477316";"0.6287549202403149";"0.3712450797596851";"0.11269939921276155";"0.8873006007872385";"0.3880256888336441";"226"
"2883635";"Laura Gerhardt";"148";"0";"148";"147";"1";"144";"4";"4";"null";"null";"0.0";"1.0";"0.9932432432432432";"0.006756756756756757";"0.972972972972973";"0.02702702702702703";"0.02702702702702703";"3"
"667690";"osmapaw";"2985";"0";"2985";"0";"2985";"746";"2239";"273";"null";"null";"0.0";"1.0";"0.0";"1.0";"0.24991624790619765";"0.7500837520938023";"0.0914572864321608";"14"
"1949759";"Bkyshr";"3";"2";"1";"2";"1";"0";"3";"0";"null";"null";"0.6666666666666666";"0.3333333333333333";"0.6666666666666666";"0.3333333333333333";"0.0";"1.0";"0.0";"3"
"1290299";"MeghaShrestha";"2564";"1176";"1388";"2366";"198";"1618";"946";"352";"null";"null";"0.45865834633385333";"0.5413416536661466";"0.9227769110764431";"0.07722308892355695";"0.6310452418096724";"0.36895475819032764";"0.1372854914196568";"61"
"520239";"Gutsycat";"18";"0";"18";"17";"1";"0";"18";"0";"null";"null";"0.0";"1.0";"0.9444444444444444";"0.05555555555555555";"0.0";"1.0";"0.0";"2"
"4612203";"Bipu Rajbhandari";"1";"0";"1";"0";"1";"1";"0";"0";"null";"null";"0.0";"1.0";"0.0";"1.0";"1.0";"0.0";"0.0";"1"
"4558952";"Ipsita Karki";"4";"0";"4";"0";"4";"4";"0";"0";"null";"null";"0.0";"1.0";"0.0";"1.0";"1.0";"0.0";"0.0";"4"
"1781812";"colllin";"4";"0";"4";"3";"1";"0";"4";"0";"null";"null";"0.0";"1.0";"0.75";"0.25";"0.0";"1.0";"0.0";"1"
"2863130";"honest10197";"562";"277";"285";"561";"1";"509";"53";"52";"null";"null";"0.4928825622775801";"0.5071174377224199";"0.998220640569395";"0.0017793594306049821";"0.905693950177936";"0.09430604982206406";"0.09252669039145907";"7"
"4911230";"kushal poudyal";"1";"0";"1";"0";"1";"1";"0";"0";"null";"null";"0.0";"1.0";"0.0";"1.0";"1.0";"0.0";"0.0";"1"
"2830366";"angsherpa";"1";"0";"1";"0";"1";"1";"0";"0";"null";"null";"0.0";"1.0";"0.0";"1.0";"1.0";"0.0";"0.0";"1"
"2244628";"sayamism";"4";"3";"1";"3";"1";"0";"4";"0";"null";"null";"0.75";"0.25";"0.75";"0.25";"0.0";"1.0";"0.0";"1"
"2879508";"pdritalia";"18";"0";"18";"17";"1";"18";"0";"0";"null";"null";"0.0";"1.0";"0.9444444444444444";"0.05555555555555555";"1.0";"0.0";"0.0";"1"
"2859115";"aaumali";"22";"0";"22";"0";"22";"8";"14";"0";"null";"null";"0.0";"1.0";"0.0";"1.0";"0.36363636363636365";"0.6363636363636364";"0.0";"2"
"4923400";"Maharjan Kadam";"1";"0";"1";"0";"1";"1";"0";"0";"null";"null";"0.0";"1.0";"0.0";"1.0";"1.0";"0.0";"0.0";"1"
"3952756";"Prabesh Maharjan";"1";"0";"1";"0";"1";"1";"0";"0";"null";"null";"0.0";"1.0";"0.0";"1.0";"1.0";"0.0";"0.0";"1"
"2998371";"SMAPPINGPVT";"6969";"6297";"672";"3966";"3003";"1654";"5315";"5298";"null";"null";"0.9035729659922515";"0.0964270340077486";"0.5690916917778734";"0.43090830822212656";"0.23733677715597648";"0.7626632228440235";"0.7602238484718037";"84"
"2412660";"Aman Chetri";"4";"0";"4";"3";"1";"4";"0";"0";"null";"null";"0.0";"1.0";"0.75";"0.25";"1.0";"0.0";"0.0";"1"
"2891901";"shellymoore22";"230";"229";"1";"229";"1";"225";"5";"0";"null";"null";"0.9956521739130435";"0.004347826086956522";"0.9956521739130435";"0.004347826086956522";"0.9782608695652174";"0.021739130434782608";"0.0";"2"
"2875512";"trentbarbee";"79";"0";"79";"78";"1";"79";"0";"0";"null";"null";"0.0";"1.0";"0.9873417721518988";"0.012658227848101266";"1.0";"0.0";"0.0";"1"
"3752036";"stouille84";"3";"1";"2";"2";"1";"3";"0";"0";"null";"null";"0.3333333333333333";"0.6666666666666666";"0.6666666666666666";"0.3333333333333333";"1.0";"0.0";"0.0";"3"
"499800";"freeExec";"639";"2";"637";"638";"1";"521";"118";"3";"null";"null";"0.003129890453834116";"0.9968701095461658";"0.9984350547730829";"0.001564945226917058";"0.8153364632237872";"0.18466353677621283";"0.004694835680751174";"2"
"4014178";"Kushal Shrestha";"4";"3";"1";"2";"2";"4";"0";"0";"null";"null";"0.75";"0.25";"0.5";"0.5";"1.0";"0.0";"0.0";"4"
"2879560";"orwh";"573";"0";"573";"572";"1";"570";"3";"0";"null";"null";"0.0";"1.0";"0.9982547993019197";"0.0017452006980802793";"0.9947643979057592";"0.005235602094240838";"0.0";"4"
"5005352";"Raj Nandan Yadav";"1";"0";"1";"0";"1";"1";"0";"0";"null";"null";"0.0";"1.0";"0.0";"1.0";"1.0";"0.0";"0.0";"1"
"2863175";"white87";"26";"25";"1";"25";"1";"26";"0";"0";"null";"null";"0.9615384615384616";"0.038461538461538464";"0.9615384615384616";"0.038461538461538464";"1.0";"0.0";"0.0";"2"
"1867890";"Samip";"536";"409";"127";"445";"91";"305";"231";"43";"null";"null";"0.7630597014925373";"0.23694029850746268";"0.8302238805970149";"0.16977611940298507";"0.5690298507462687";"0.43097014925373134";"0.08022388059701492";"22"
"2891868";"kamemar";"88";"87";"1";"87";"1";"63";"25";"25";"null";"null";"0.9886363636363636";"0.011363636363636364";"0.9886363636363636";"0.011363636363636364";"0.7159090909090909";"0.2840909090909091";"0.2840909090909091";"1"
"4939833";"Govind Pandey";"1";"0";"1";"0";"1";"0";"1";"0";"null";"null";"0.0";"1.0";"0.0";"1.0";"0.0";"1.0";"0.0";"1"
"2429008";"CFearn";"202";"0";"202";"0";"202";"196";"6";"0";"null";"null";"0.0";"1.0";"0.0";"1.0";"0.9702970297029703";"0.0297029702970297";"0.0";"12"
"1716320";"alesarrett";"92";"0";"92";"91";"1";"90";"2";"0";"null";"null";"0.0";"1.0";"0.9891304347826086";"0.010869565217391304";"0.9782608695652174";"0.021739130434782608";"0.0";"3"
"4694076";"Kishor Bogati";"2";"1";"1";"1";"1";"1";"1";"0";"null";"null";"0.5";"0.5";"0.5";"0.5";"0.5";"0.5";"0.0";"2"
"270456";"pyrog";"2";"0";"2";"1";"1";"0";"2";"0";"null";"null";"0.0";"1.0";"0.5";"0.5";"0.0";"1.0";"0.0";"2"
"327803";"bekreyev";"66";"65";"1";"65";"1";"48";"18";"0";"null";"null";"0.9848484848484849";"0.015151515151515152";"0.9848484848484849";"0.015151515151515152";"0.7272727272727273";"0.2727272727272727";"0.0";"2"
"4169917";"Vikram Karki";"1";"0";"1";"0";"1";"1";"0";"0";"null";"null";"0.0";"1.0";"0.0";"1.0";"1.0";"0.0";"0.0";"1"
"2875560";"ly_tak";"47";"0";"47";"46";"1";"46";"1";"0";"null";"null";"0.0";"1.0";"0.9787234042553191";"0.02127659574468085";"0.9787234042553191";"0.02127659574468085";"0.0";"2"
"1126548";"maharjanshirish";"74";"73";"1";"0";"74";"68";"6";"2";"null";"null";"0.9864864864864865";"0.013513513513513514";"0.0";"1.0";"0.918918918918919";"0.08108108108108109";"0.02702702702702703";"22"
"680067";"amritkarma";"2005";"1043";"962";"1516";"489";"310";"1695";"1334";"null";"null";"0.5201995012468827";"0.4798004987531172";"0.7561097256857855";"0.24389027431421445";"0.1546134663341646";"0.8453865336658354";"0.6653366583541147";"85"
"4288715";"Binaya Shrestha";"19";"8";"11";"18";"1";"0";"19";"1";"null";"null";"0.42105263157894735";"0.5789473684210527";"0.9473684210526315";"0.05263157894736842";"0.0";"1.0";"0.05263157894736842";"4"
"4145330";"Dylan Magnani";"1";"0";"1";"0";"1";"1";"0";"0";"null";"null";"0.0";"1.0";"0.0";"1.0";"1.0";"0.0";"0.0";"1"
"4477130";"Asim Gautam";"1";"0";"1";"0";"1";"0";"1";"0";"null";"null";"0.0";"1.0";"0.0";"1.0";"0.0";"1.0";"0.0";"1"
"2871483";"Chuan Hao Chen";"564";"0";"564";"563";"1";"551";"13";"4";"null";"null";"0.0";"1.0";"0.99822695035461";"0.0017730496453900709";"0.9769503546099291";"0.02304964539007092";"0.0070921985815602835";"5"
"8339";"mtmail";"4";"0";"4";"0";"4";"0";"4";"0";"null";"null";"0.0";"1.0";"0.0";"1.0";"0.0";"1.0";"0.0";"1"
"3346599";"Danielle_Barlow";"896";"0";"896";"895";"1";"805";"91";"57";"null";"null";"0.0";"1.0";"0.9988839285714286";"0.0011160714285714285";"0.8984375";"0.1015625";"0.06361607142857142";"6"
"4108458";"Jorge Jardim";"1";"0";"1";"0";"1";"1";"0";"0";"null";"null";"0.0";"1.0";"0.0";"1.0";"1.0";"0.0";"0.0";"1"
"2859197";"perrier1978";"308";"0";"308";"0";"308";"283";"25";"11";"null";"null";"0.0";"1.0";"0.0";"1.0";"0.9188311688311688";"0.08116883116883117";"0.03571428571428571";"4"
"2887866";"Ana David";"41";"0";"41";"0";"41";"41";"0";"0";"null";"null";"0.0";"1.0";"0.0";"1.0";"1.0";"0.0";"0.0";"3"
"3002551";"aakashsigdel";"8";"7";"1";"1";"7";"4";"4";"0";"null";"null";"0.875";"0.125";"0.125";"0.875";"0.5";"0.5";"0.0";"4"
"2875529";"geo_nic";"98";"0";"98";"97";"1";"90";"8";"4";"null";"null";"0.0";"1.0";"0.9897959183673469";"0.01020408163265306";"0.9183673469387755";"0.08163265306122448";"0.04081632653061224";"7"
"139424";"pigsonthewing";"1";"0";"1";"0";"1";"0";"1";"0";"null";"null";"0.0";"1.0";"0.0";"1.0";"0.0";"1.0";"0.0";"1"
"2863247";"Willy Duarte";"21";"0";"21";"20";"1";"21";"0";"0";"null";"null";"0.0";"1.0";"0.9523809523809523";"0.047619047619047616";"1.0";"0.0";"0.0";"1"
"3346586";"gsjulien";"746";"0";"746";"745";"1";"407";"339";"33";"null";"null";"0.0";"1.0";"0.9986595174262735";"0.0013404825737265416";"0.5455764075067024";"0.4544235924932976";"0.04423592493297587";"7"
"94381";"tadanet3";"339";"0";"339";"0";"339";"339";"0";"0";"null";"null";"0.0";"1.0";"0.0";"1.0";"1.0";"0.0";"0.0";"2"
"2875547";"ben4343";"169";"0";"169";"168";"1";"169";"0";"0";"null";"null";"0.0";"1.0";"0.9940828402366864";"0.005917159763313609";"1.0";"0.0";"0.0";"4"
"2781339";"Pierre Oftinger";"5";"0";"5";"4";"1";"4";"1";"0";"null";"null";"0.0";"1.0";"0.8";"0.2";"0.8";"0.2";"0.0";"1"
"3715211";"birenra";"48";"47";"1";"47";"1";"43";"5";"3";"null";"null";"0.9791666666666666";"0.020833333333333332";"0.9791666666666666";"0.020833333333333332";"0.8958333333333334";"0.10416666666666667";"0.0625";"11"
"4899068";"Brabim";"9";"1";"8";"3";"6";"0";"9";"0";"null";"null";"0.1111111111111111";"0.8888888888888888";"0.3333333333333333";"0.6666666666666666";"0.0";"1.0";"0.0";"3"
"2879633";"Eager Mapper";"11";"0";"11";"10";"1";"11";"0";"0";"null";"null";"0.0";"1.0";"0.9090909090909091";"0.09090909090909091";"1.0";"0.0";"0.0";"2"
"1179861";"Monica358msd";"8";"7";"1";"7";"1";"8";"0";"0";"null";"null";"0.875";"0.125";"0.875";"0.125";"1.0";"0.0";"0.0";"2"
"1949914";"Christoph Gysin";"6";"5";"1";"5";"1";"6";"0";"0";"null";"null";"0.8333333333333334";"0.16666666666666666";"0.8333333333333334";"0.16666666666666666";"1.0";"0.0";"0.0";"1"
"3035366";"vinodtelematics";"6";"5";"1";"0";"6";"6";"0";"0";"null";"null";"0.8333333333333334";"0.16666666666666666";"0.0";"1.0";"1.0";"0.0";"0.0";"2"
"4993157";"Borninsane13";"3";"0";"3";"2";"1";"2";"1";"0";"null";"null";"0.0";"1.0";"0.6666666666666666";"0.3333333333333333";"0.6666666666666666";"0.3333333333333333";"0.0";"1"
"155855";"NickBroon";"30";"0";"30";"29";"1";"26";"4";"0";"null";"null";"0.0";"1.0";"0.9666666666666667";"0.03333333333333333";"0.8666666666666667";"0.13333333333333333";"0.0";"1"
"16591";"neuhausr";"2";"0";"2";"1";"1";"0";"2";"0";"null";"null";"0.0";"1.0";"0.5";"0.5";"0.0";"1.0";"0.0";"2"
"1818836";"raulecay";"388";"0";"388";"387";"1";"388";"0";"0";"null";"null";"0.0";"1.0";"0.9974226804123711";"0.002577319587628866";"1.0";"0.0";"0.0";"5"
"2851067";"Capri853";"80";"79";"1";"79";"1";"80";"0";"0";"null";"null";"0.9875";"0.0125";"0.9875";"0.0125";"1.0";"0.0";"0.0";"12"
"16595";"Corriere";"276";"275";"1";"275";"1";"190";"86";"2";"null";"null";"0.9963768115942029";"0.0036231884057971015";"0.9963768115942029";"0.0036231884057971015";"0.6884057971014492";"0.3115942028985507";"0.007246376811594203";"4"
"3793120";"NischalAwal";"1";"0";"1";"0";"1";"1";"0";"0";"null";"null";"0.0";"1.0";"0.0";"1.0";"1.0";"0.0";"0.0";"1"
"2883831";"FireMapMkr";"25";"0";"25";"0";"25";"25";"0";"0";"null";"null";"0.0";"1.0";"0.0";"1.0";"1.0";"0.0";"0.0";"2"
"1286351";"Bijesh";"16";"15";"1";"15";"1";"0";"16";"0";"null";"null";"0.9375";"0.0625";"0.9375";"0.0625";"0.0";"1.0";"0.0";"1"
"4817045";"Guru Dev";"2";"1";"1";"1";"1";"2";"0";"0";"null";"null";"0.5";"0.5";"0.5";"0.5";"1.0";"0.0";"0.0";"2"
"3866843";"Basu Adhikari";"1";"0";"1";"0";"1";"1";"0";"0";"null";"null";"0.0";"1.0";"0.0";"1.0";"1.0";"0.0";"0.0";"1"
"2273475";"kdgis";"16";"0";"16";"15";"1";"15";"1";"0";"null";"null";"0.0";"1.0";"0.9375";"0.0625";"0.9375";"0.0625";"0.0";"3"
"2273472";"Aadeethakuri";"20";"0";"20";"19";"1";"20";"0";"0";"null";"null";"0.0";"1.0";"0.95";"0.05";"1.0";"0.0";"0.0";"1"
"4731050";"worldtravellerHB";"1";"0";"1";"0";"1";"1";"0";"0";"null";"null";"0.0";"1.0";"0.0";"1.0";"1.0";"0.0";"0.0";"1"
"2273478";"Aman Maharjan";"47";"46";"1";"0";"47";"47";"0";"0";"null";"null";"0.9787234042553191";"0.02127659574468085";"0.0";"1.0";"1.0";"0.0";"0.0";"6"
"2883784";"Joe Moffat";"41";"0";"41";"34";"7";"41";"0";"0";"null";"null";"0.0";"1.0";"0.8292682926829268";"0.17073170731707318";"1.0";"0.0";"0.0";"9"
"4628643";"Raveen Shrestha";"2";"1";"1";"0";"2";"1";"1";"0";"null";"null";"0.5";"0.5";"0.0";"1.0";"0.5";"0.5";"0.0";"1"
"1237243";"asjbrana";"52";"51";"1";"32";"20";"24";"28";"20";"null";"null";"0.9807692307692307";"0.019230769230769232";"0.6153846153846154";"0.38461538461538464";"0.46153846153846156";"0.5384615384615384";"0.38461538461538464";"8"
"2273483";"Apar";"37";"1";"36";"35";"2";"37";"0";"0";"null";"null";"0.02702702702702703";"0.972972972972973";"0.9459459459459459";"0.05405405405405406";"1.0";"0.0";"0.0";"8"
"2273481";"Kristan Shrestha";"35";"34";"1";"0";"35";"11";"24";"3";"null";"null";"0.9714285714285714";"0.02857142857142857";"0.0";"1.0";"0.3142857142857143";"0.6857142857142857";"0.08571428571428572";"4"
"4223150";"gupta_pawan";"83";"32";"51";"82";"1";"71";"12";"0";"null";"null";"0.3855421686746988";"0.6144578313253012";"0.9879518072289156";"0.012048192771084338";"0.8554216867469879";"0.14457831325301204";"0.0";"19"
"2863301";"CesarCortes";"12";"0";"12";"11";"1";"12";"0";"0";"null";"null";"0.0";"1.0";"0.9166666666666666";"0.08333333333333333";"1.0";"0.0";"0.0";"1"
"2273491";"prava";"13";"12";"1";"12";"1";"13";"0";"0";"null";"null";"0.9230769230769231";"0.07692307692307693";"0.9230769230769231";"0.07692307692307693";"1.0";"0.0";"0.0";"2"
"5009593";"SangamThapa";"19";"0";"19";"18";"1";"17";"2";"1";"null";"null";"0.0";"1.0";"0.9473684210526315";"0.05263157894736842";"0.8947368421052632";"0.10526315789473684";"0.05263157894736842";"5"
"2871518";"lizziebennett";"4";"0";"4";"3";"1";"4";"0";"0";"null";"null";"0.0";"1.0";"0.75";"0.25";"1.0";"0.0";"0.0";"1"
"4202682";"Pratik Ghimire";"1";"0";"1";"0";"1";"1";"0";"0";"null";"null";"0.0";"1.0";"0.0";"1.0";"1.0";"0.0";"0.0";"1"
"4223165";"Sunil Kumar Shrestha";"79";"25";"54";"53";"26";"53";"26";"8";"null";"null";"0.31645569620253167";"0.6835443037974683";"0.6708860759493671";"0.3291139240506329";"0.6708860759493671";"0.3291139240506329";"0.10126582278481013";"31"
"8445";"shoragan";"4";"3";"1";"3";"1";"4";"0";"0";"null";"null";"0.75";"0.25";"0.75";"0.25";"1.0";"0.0";"0.0";"1"
"1597669";"mmalgouveia";"44";"0";"44";"43";"1";"44";"0";"0";"null";"null";"0.0";"1.0";"0.9772727272727273";"0.022727272727272728";"1.0";"0.0";"0.0";"5"
"2896083";"DITPiranha";"67";"0";"67";"66";"1";"67";"0";"0";"null";"null";"0.0";"1.0";"0.9850746268656716";"0.014925373134328358";"1.0";"0.0";"0.0";"1"
"4092220";"Rick Weimar";"1";"0";"1";"0";"1";"1";"0";"0";"null";"null";"0.0";"1.0";"0.0";"1.0";"1.0";"0.0";"0.0";"1"
"2613540";"MEDS";"141";"140";"1";"140";"1";"141";"0";"0";"null";"null";"0.9929078014184397";"0.0070921985815602835";"0.9929078014184397";"0.0070921985815602835";"1.0";"0.0";"0.0";"1"
"1814808";"BNaito";"18";"0";"18";"0";"18";"18";"0";"0";"null";"null";"0.0";"1.0";"0.0";"1.0";"1.0";"0.0";"0.0";"1"
"4694337";"Lissandro Silva";"3";"2";"1";"1";"2";"3";"0";"0";"null";"null";"0.6666666666666666";"0.3333333333333333";"0.3333333333333333";"0.6666666666666666";"1.0";"0.0";"0.0";"3"
"3559729";"kpp";"1";"0";"1";"0";"1";"0";"1";"0";"null";"null";"0.0";"1.0";"0.0";"1.0";"0.0";"1.0";"0.0";"1"
"4841799";"Anup Neupane";"1";"0";"1";"0";"1";"1";"0";"0";"null";"null";"0.0";"1.0";"0.0";"1.0";"1.0";"0.0";"0.0";"1"
"5034332";"Hero Ram";"4";"0";"4";"3";"1";"4";"0";"0";"null";"null";"0.0";"1.0";"0.75";"0.25";"1.0";"0.0";"0.0";"1"
"2879802";"Suku";"2";"0";"2";"1";"1";"1";"1";"0";"null";"null";"0.0";"1.0";"0.5";"0.5";"0.5";"0.5";"0.0";"1"
"4190510";"Bipin Shakya1";"2";"0";"2";"1";"1";"1";"1";"0";"null";"null";"0.0";"1.0";"0.5";"0.5";"0.5";"0.5";"0.0";"2"
"454932";"Cyrille37";"79";"77";"2";"77";"2";"71";"8";"3";"null";"null";"0.9746835443037974";"0.02531645569620253";"0.9746835443037974";"0.02531645569620253";"0.8987341772151899";"0.10126582278481013";"0.0379746835443038";"5"
"766233";"Kretzer";"340";"339";"1";"339";"1";"289";"51";"9";"null";"null";"0.9970588235294118";"0.0029411764705882353";"0.9970588235294118";"0.0029411764705882353";"0.85";"0.15";"0.026470588235294117";"5"
"1351937";"Subarna Maharjan";"12";"11";"1";"11";"1";"9";"3";"1";"null";"null";"0.9166666666666666";"0.08333333333333333";"0.9166666666666666";"0.08333333333333333";"0.75";"0.25";"0.08333333333333333";"6"
"2871613";"melina martinez";"371";"0";"371";"370";"1";"371";"0";"0";"null";"null";"0.0";"1.0";"0.9973045822102425";"0.0026954177897574125";"1.0";"0.0";"0.0";"3"
"1806604";"TrailRunning";"20";"0";"20";"19";"1";"0";"20";"0";"null";"null";"0.0";"1.0";"0.95";"0.05";"0.0";"1.0";"0.0";"1"
"1700096";"GautamPratik";"2725";"1570";"1155";"1628";"1097";"828";"1897";"1042";"null";"null";"0.5761467889908257";"0.42385321100917434";"0.5974311926605504";"0.40256880733944955";"0.3038532110091743";"0.6961467889908257";"0.38238532110091744";"245"
"4817232";"Jiwan Ilameli";"3";"1";"2";"1";"2";"2";"1";"0";"null";"null";"0.3333333333333333";"0.6666666666666666";"0.3333333333333333";"0.6666666666666666";"0.6666666666666666";"0.3333333333333333";"0.0";"3"
"2875698";"rlaurentinus";"138";"80";"58";"0";"138";"134";"4";"0";"null";"null";"0.5797101449275363";"0.42028985507246375";"0.0";"1.0";"0.9710144927536232";"0.028985507246376812";"0.0";"2"
"1974532";"Stefano frittelli";"100";"99";"1";"99";"1";"92";"8";"0";"null";"null";"0.99";"0.01";"0.99";"0.01";"0.92";"0.08";"0.0";"21"
"413978";"Rbanick";"448";"275";"173";"281";"167";"390";"58";"5";"null";"null";"0.6138392857142857";"0.3861607142857143";"0.6272321428571429";"0.37276785714285715";"0.8705357142857143";"0.12946428571428573";"0.011160714285714286";"26"
"3977504";"2tug4bug";"1";"0";"1";"0";"1";"1";"0";"0";"null";"null";"0.0";"1.0";"0.0";"1.0";"1.0";"0.0";"0.0";"1"
"2867508";"kansakar";"14";"0";"14";"13";"1";"11";"3";"0";"null";"null";"0.0";"1.0";"0.9285714285714286";"0.07142857142857142";"0.7857142857142857";"0.21428571428571427";"0.0";"3"
"155936";"palimpadum";"115";"114";"1";"0";"115";"41";"74";"11";"null";"null";"0.991304347826087";"0.008695652173913044";"0.0";"1.0";"0.3565217391304348";"0.6434782608695652";"0.09565217391304348";"2"
"2216201";"alexz3";"2";"0";"2";"0";"2";"0";"2";"0";"null";"null";"0.0";"1.0";"0.0";"1.0";"0.0";"1.0";"0.0";"1"
"2875649";"himalayancode";"10";"0";"10";"9";"1";"10";"0";"0";"null";"null";"0.0";"1.0";"0.9";"0.1";"1.0";"0.0";"0.0";"2"
"4747622";"Bimal Gurung";"3";"2";"1";"2";"1";"3";"0";"0";"null";"null";"0.6666666666666666";"0.3333333333333333";"0.6666666666666666";"0.3333333333333333";"1.0";"0.0";"0.0";"1"
"2875653";"jordi versteege";"58";"0";"58";"57";"1";"58";"0";"0";"null";"null";"0.0";"1.0";"0.9827586206896551";"0.017241379310344827";"1.0";"0.0";"0.0";"2"
"516407";"BF89";"381";"0";"381";"380";"1";"349";"32";"13";"null";"null";"0.0";"1.0";"0.9973753280839895";"0.0026246719160104987";"0.916010498687664";"0.08398950131233596";"0.03412073490813648";"14"
"2875674";"Jasper C";"156";"0";"156";"155";"1";"156";"0";"0";"null";"null";"0.0";"1.0";"0.9935897435897436";"0.00641025641025641";"1.0";"0.0";"0.0";"26"
"2920734";"yanyu088";"16";"15";"1";"15";"1";"0";"16";"0";"null";"null";"0.9375";"0.0625";"0.9375";"0.0625";"0.0";"1.0";"0.0";"1"
"2863385";"katuddy";"12";"0";"12";"11";"1";"12";"0";"0";"null";"null";"0.0";"1.0";"0.9166666666666666";"0.08333333333333333";"1.0";"0.0";"0.0";"1"
"3899656";"Battery Low";"1";"0";"1";"0";"1";"0";"1";"0";"null";"null";"0.0";"1.0";"0.0";"1.0";"0.0";"1.0";"0.0";"1"
"57652";"richardbrinkman";"270";"102";"168";"269";"1";"116";"154";"50";"null";"null";"0.37777777777777777";"0.6222222222222222";"0.9962962962962963";"0.003703703703703704";"0.42962962962962964";"0.5703703703703704";"0.18518518518518517";"3"
"4350325";"SudeepWV";"41";"40";"1";"40";"1";"8";"33";"0";"null";"null";"0.975609756097561";"0.024390243902439025";"0.975609756097561";"0.024390243902439025";"0.1951219512195122";"0.8048780487804879";"0.0";"2"
"4116745";"Ashutosh Shrestha";"5";"1";"4";"3";"2";"4";"1";"0";"null";"null";"0.2";"0.8";"0.6";"0.4";"0.8";"0.2";"0.0";"5"
"1454383";"Nizil";"73";"0";"73";"0";"73";"69";"4";"0";"null";"null";"0.0";"1.0";"0.0";"1.0";"0.9452054794520548";"0.0547945205479452";"0.0";"3"
"4878707";"Layang Lama";"1";"0";"1";"0";"1";"1";"0";"0";"null";"null";"0.0";"1.0";"0.0";"1.0";"1.0";"0.0";"0.0";"1"
"2896151";"rabinnankhwa";"8";"0";"8";"7";"1";"4";"4";"0";"null";"null";"0.0";"1.0";"0.875";"0.125";"0.5";"0.5";"0.0";"3"
"4497668";"Ukes Lakhaju";"1";"0";"1";"0";"1";"1";"0";"0";"null";"null";"0.0";"1.0";"0.0";"1.0";"1.0";"0.0";"0.0";"1"
"2888047";"Janifm";"16";"0";"16";"15";"1";"8";"8";"0";"null";"null";"0.0";"1.0";"0.9375";"0.0625";"0.5";"0.5";"0.0";"2"
"3375477";"Saroj Pokhrel";"2";"1";"1";"1";"1";"2";"0";"0";"null";"null";"0.5";"0.5";"0.5";"0.5";"1.0";"0.0";"0.0";"2"
"2883941";"visualicia";"159";"89";"70";"158";"1";"158";"1";"0";"null";"null";"0.559748427672956";"0.44025157232704404";"0.9937106918238994";"0.006289308176100629";"0.9937106918238994";"0.006289308176100629";"0.0";"32"
"4325647";"Sanis Maharjan";"1";"0";"1";"0";"1";"1";"0";"0";"null";"null";"0.0";"1.0";"0.0";"1.0";"1.0";"0.0";"0.0";"1"
"4354316";"Frank_Online";"1";"0";"1";"0";"1";"1";"0";"0";"null";"null";"0.0";"1.0";"0.0";"1.0";"1.0";"0.0";"0.0";"1"
"69966";"ikiya";"173";"172";"1";"172";"1";"160";"13";"8";"null";"null";"0.9942196531791907";"0.005780346820809248";"0.9942196531791907";"0.005780346820809248";"0.9248554913294798";"0.07514450867052024";"0.046242774566473986";"1"
"3801450";"N Ryan Sharma";"141";"83";"58";"102";"39";"121";"20";"3";"null";"null";"0.5886524822695035";"0.41134751773049644";"0.723404255319149";"0.2765957446808511";"0.8581560283687943";"0.14184397163120568";"0.02127659574468085";"73"
"2859386";"skb347";"182";"0";"182";"181";"1";"182";"0";"0";"null";"null";"0.0";"1.0";"0.9945054945054945";"0.005494505494505495";"1.0";"0.0";"0.0";"16"
"414035";"Akimasa";"58";"8";"50";"15";"43";"49";"9";"0";"null";"null";"0.13793103448275862";"0.8620689655172413";"0.25862068965517243";"0.7413793103448276";"0.8448275862068966";"0.15517241379310345";"0.0";"5"
"3875182";"QuestVolunteer";"1";"0";"1";"0";"1";"1";"0";"0";"null";"null";"0.0";"1.0";"0.0";"1.0";"1.0";"0.0";"0.0";"1"
"483666";"DanJSY";"4";"0";"4";"3";"1";"4";"0";"0";"null";"null";"0.0";"1.0";"0.75";"0.25";"1.0";"0.0";"0.0";"1"
"3481954";"Simon Candelaresi";"2";"0";"2";"1";"1";"2";"0";"0";"null";"null";"0.0";"1.0";"0.5";"0.5";"1.0";"0.0";"0.0";"1"
"864593";"Sazal(Solaris)";"881";"506";"375";"670";"211";"399";"482";"154";"null";"null";"0.5743473325766175";"0.42565266742338254";"0.7604994324631101";"0.2395005675368899";"0.452894438138479";"0.547105561861521";"0.17480136208853575";"62"
"1859964";"StefViajando";"5";"0";"5";"4";"1";"4";"1";"1";"null";"null";"0.0";"1.0";"0.8";"0.2";"0.8";"0.2";"0.2";"2"
"1847672";"wmd123";"16";"0";"16";"15";"1";"14";"2";"0";"null";"null";"0.0";"1.0";"0.9375";"0.0625";"0.875";"0.125";"0.0";"3"
"2896201";"prabhatsgautam";"16";"0";"16";"15";"1";"8";"8";"0";"null";"null";"0.0";"1.0";"0.9375";"0.0625";"0.5";"0.5";"0.0";"4"
"2146630";"Sharotta";"4";"3";"1";"3";"1";"4";"0";"0";"null";"null";"0.75";"0.25";"0.75";"0.25";"1.0";"0.0";"0.0";"1"
"1212788";"mjfoster83";"5";"0";"5";"4";"1";"4";"1";"0";"null";"null";"0.0";"1.0";"0.8";"0.2";"0.8";"0.2";"0.0";"1"
"1077625";"binamra";"9";"0";"9";"8";"1";"4";"5";"1";"null";"null";"0.0";"1.0";"0.8888888888888888";"0.1111111111111111";"0.4444444444444444";"0.5555555555555556";"0.1111111111111111";"5"
"631141";"Ryo-a";"1035";"178";"857";"1034";"1";"955";"80";"8";"null";"null";"0.17198067632850242";"0.8280193236714976";"0.9990338164251208";"9.66183574879227E-4";"0.9227053140096618";"0.07729468599033816";"0.007729468599033816";"18"
"2879815";"musimuse";"2";"0";"2";"1";"1";"2";"0";"0";"null";"null";"0.0";"1.0";"0.5";"0.5";"1.0";"0.0";"0.0";"1"
"3453272";"anupsth";"1";"0";"1";"0";"1";"1";"0";"0";"null";"null";"0.0";"1.0";"0.0";"1.0";"1.0";"0.0";"0.0";"1"
"4063571";"Pitambar Gautam";"8";"7";"1";"7";"1";"8";"0";"0";"null";"null";"0.875";"0.125";"0.875";"0.125";"1.0";"0.0";"0.0";"3"
"2412874";"Sumanta";"4";"3";"1";"3";"1";"4";"0";"0";"null";"null";"0.75";"0.25";"0.75";"0.25";"1.0";"0.0";"0.0";"1"
"1786228";"TamiMorse";"23";"0";"23";"22";"1";"23";"0";"0";"null";"null";"0.0";"1.0";"0.9565217391304348";"0.043478260869565216";"1.0";"0.0";"0.0";"1"
"4866362";"Punaram Kharel";"1";"0";"1";"0";"1";"1";"0";"0";"null";"null";"0.0";"1.0";"0.0";"1.0";"1.0";"0.0";"0.0";"1"
"3342657";"Theroyale";"2";"0";"2";"0";"2";"2";"0";"0";"null";"null";"0.0";"1.0";"0.0";"1.0";"1.0";"0.0";"0.0";"2"
"2986335";"Bharati Adhikari";"19";"0";"19";"18";"1";"15";"4";"0";"null";"null";"0.0";"1.0";"0.9473684210526315";"0.05263157894736842";"0.7894736842105263";"0.21052631578947367";"0.0";"1"
"94578";"andygol";"6";"5";"1";"5";"1";"0";"6";"6";"null";"null";"0.8333333333333334";"0.16666666666666666";"0.8333333333333334";"0.16666666666666666";"0.0";"1.0";"1.0";"1"
"4456755";"Milan Awale";"1";"0";"1";"0";"1";"1";"0";"0";"null";"null";"0.0";"1.0";"0.0";"1.0";"1.0";"0.0";"0.0";"1"
"217467";"tgertin";"45";"0";"45";"44";"1";"15";"30";"1";"null";"null";"0.0";"1.0";"0.9777777777777777";"0.022222222222222223";"0.3333333333333333";"0.6666666666666666";"0.022222222222222223";"6"
"5034444";"laxmi krishna Prajapati";"1";"0";"1";"0";"1";"1";"0";"0";"null";"null";"0.0";"1.0";"0.0";"1.0";"1.0";"0.0";"0.0";"1"
"1122708";"zaizone";"272";"0";"272";"271";"1";"272";"0";"0";"null";"null";"0.0";"1.0";"0.9963235294117647";"0.003676470588235294";"1.0";"0.0";"0.0";"2"
"4350404";"Krish42";"17";"13";"4";"16";"1";"10";"7";"5";"null";"null";"0.7647058823529411";"0.23529411764705882";"0.9411764705882353";"0.058823529411764705";"0.5882352941176471";"0.4117647058823529";"0.29411764705882354";"3"
"1806748";"Alien_mah";"97";"0";"97";"0";"97";"89";"8";"4";"null";"null";"0.0";"1.0";"0.0";"1.0";"0.9175257731958762";"0.08247422680412371";"0.041237113402061855";"7"
"1876372";"smjrifle";"2";"0";"2";"1";"1";"1";"1";"0";"null";"null";"0.0";"1.0";"0.5";"0.5";"0.5";"0.5";"0.0";"1"
"2875810";"Kerstin Saalmann";"168";"0";"168";"167";"1";"150";"18";"0";"null";"null";"0.0";"1.0";"0.9940476190476191";"0.005952380952380952";"0.8928571428571429";"0.10714285714285714";"0.0";"5"
"2892197";"Raja streetmap";"1";"0";"1";"0";"1";"0";"1";"0";"null";"null";"0.0";"1.0";"0.0";"1.0";"0.0";"1.0";"0.0";"1"
"2949542";"Loojah";"15";"8";"7";"14";"1";"10";"5";"4";"null";"null";"0.5333333333333333";"0.4666666666666667";"0.9333333333333333";"0.06666666666666667";"0.6666666666666666";"0.3333333333333333";"0.26666666666666666";"3"
"4760005";"TeaTime13";"1";"0";"1";"0";"1";"1";"0";"0";"null";"null";"0.0";"1.0";"0.0";"1.0";"1.0";"0.0";"0.0";"1"
"3187134";"Saharsha";"3";"0";"3";"2";"1";"3";"0";"0";"null";"null";"0.0";"1.0";"0.6666666666666666";"0.3333333333333333";"1.0";"0.0";"0.0";"2"
"4350413";"Sheru Thakuri";"8";"7";"1";"7";"1";"3";"5";"0";"null";"null";"0.875";"0.125";"0.875";"0.125";"0.375";"0.625";"0.0";"2"
"2400693";"SoleneV";"47";"0";"47";"0";"47";"11";"36";"0";"null";"null";"0.0";"1.0";"0.0";"1.0";"0.23404255319148937";"0.7659574468085106";"0.0";"1"
"2752952";"jorgkv";"6";"0";"6";"5";"1";"6";"0";"0";"null";"null";"0.0";"1.0";"0.8333333333333334";"0.16666666666666666";"1.0";"0.0";"0.0";"1"
"2884031";"Allison Suhan";"11";"0";"11";"0";"11";"9";"2";"2";"null";"null";"0.0";"1.0";"0.0";"1.0";"0.8181818181818182";"0.18181818181818182";"0.18181818181818182";"1"
"2859455";"Jeenal";"425";"0";"425";"359";"66";"380";"45";"1";"null";"null";"0.0";"1.0";"0.8447058823529412";"0.15529411764705883";"0.8941176470588236";"0.10588235294117647";"0.002352941176470588";"38"
"3346854";"Katelips";"423";"0";"423";"422";"1";"352";"71";"2";"null";"null";"0.0";"1.0";"0.9976359338061466";"0.002364066193853428";"0.8321513002364066";"0.16784869976359337";"0.004728132387706856";"6"
"283037";"DasNordlicht";"295";"0";"295";"294";"1";"274";"21";"17";"null";"null";"0.0";"1.0";"0.9966101694915255";"0.003389830508474576";"0.9288135593220339";"0.0711864406779661";"0.0576271186440678";"2"
"4362717";"ZAMO59";"1";"0";"1";"0";"1";"1";"0";"0";"null";"null";"0.0";"1.0";"0.0";"1.0";"1.0";"0.0";"0.0";"1"
"2720182";"BGMSM";"9";"0";"9";"8";"1";"4";"5";"1";"null";"null";"0.0";"1.0";"0.8888888888888888";"0.1111111111111111";"0.4444444444444444";"0.5555555555555556";"0.1111111111111111";"2"
"3289490";"AmritaT";"14";"13";"1";"13";"1";"11";"3";"0";"null";"null";"0.9285714285714286";"0.07142857142857142";"0.9285714285714286";"0.07142857142857142";"0.7857142857142857";"0.21428571428571427";"0.0";"2"
"24996";"Nama";"70";"41";"29";"37";"33";"30";"40";"11";"null";"null";"0.5857142857142857";"0.4142857142857143";"0.5285714285714286";"0.4714285714285714";"0.42857142857142855";"0.5714285714285714";"0.15714285714285714";"13"
"1573308";"Quinn Comendant";"9";"8";"1";"8";"1";"9";"0";"0";"null";"null";"0.8888888888888888";"0.1111111111111111";"0.8888888888888888";"0.1111111111111111";"1.0";"0.0";"0.0";"2"
"4723182";"Kshitij Subedi";"1";"0";"1";"0";"1";"1";"0";"0";"null";"null";"0.0";"1.0";"0.0";"1.0";"1.0";"0.0";"0.0";"1"
"3346843";"KAnnGlueck";"204";"0";"204";"0";"204";"181";"23";"15";"null";"null";"0.0";"1.0";"0.0";"1.0";"0.8872549019607843";"0.11274509803921569";"0.07352941176470588";"2"
"2875777";"Pimail Project";"62";"0";"62";"61";"1";"46";"16";"16";"null";"null";"0.0";"1.0";"0.9838709677419355";"0.016129032258064516";"0.7419354838709677";"0.25806451612903225";"0.25806451612903225";"2"
"2879872";"Yunjie";"221";"0";"221";"220";"1";"221";"0";"0";"null";"null";"0.0";"1.0";"0.995475113122172";"0.004524886877828055";"1.0";"0.0";"0.0";"1"
"827808";"yogi_ks";"1496";"0";"1496";"1026";"470";"1452";"44";"0";"null";"null";"0.0";"1.0";"0.6858288770053476";"0.3141711229946524";"0.9705882352941176";"0.029411764705882353";"0.0";"37"
"274857";"Supaplex";"170";"169";"1";"169";"1";"168";"2";"0";"null";"null";"0.9941176470588236";"0.0058823529411764705";"0.9941176470588236";"0.0058823529411764705";"0.9882352941176471";"0.011764705882352941";"0.0";"3"
"1847730";"Geoaashu";"7";"6";"1";"0";"7";"7";"0";"0";"null";"null";"0.8571428571428571";"0.14285714285714285";"0.0";"1.0";"1.0";"0.0";"0.0";"2"
"2257299";"nokutu";"58";"57";"1";"0";"58";"27";"31";"5";"null";"null";"0.9827586206896551";"0.017241379310344827";"0.0";"1.0";"0.46551724137931033";"0.5344827586206896";"0.08620689655172414";"1"
"655800";"hpanno";"171";"0";"171";"170";"1";"166";"5";"1";"null";"null";"0.0";"1.0";"0.9941520467836257";"0.005847953216374269";"0.9707602339181286";"0.029239766081871343";"0.005847953216374269";"3"
"2531732";"Bastenbas";"19";"0";"19";"18";"1";"19";"0";"0";"null";"null";"0.0";"1.0";"0.9473684210526315";"0.05263157894736842";"1.0";"0.0";"0.0";"3"
"1634734";"procyon43";"54";"0";"54";"53";"1";"54";"0";"0";"null";"null";"0.0";"1.0";"0.9814814814814815";"0.018518518518518517";"1.0";"0.0";"0.0";"1"
"29111";"hsc666";"1";"0";"1";"0";"1";"0";"1";"1";"null";"null";"0.0";"1.0";"0.0";"1.0";"0.0";"1.0";"1.0";"1"
"5001723";"Nilesh Prz";"1";"0";"1";"0";"1";"1";"0";"0";"null";"null";"0.0";"1.0";"0.0";"1.0";"1.0";"0.0";"0.0";"1"
"4350337";"Hira Adhikari";"4";"3";"1";"3";"1";"3";"1";"0";"null";"null";"0.75";"0.25";"0.75";"0.25";"0.75";"0.25";"0.0";"1"
"4223366";"surit";"5";"0";"5";"4";"1";"0";"5";"0";"null";"null";"0.0";"1.0";"0.8";"0.2";"0.0";"1.0";"0.0";"1"
"4350340";"Apsara Rai";"18";"17";"1";"17";"1";"6";"12";"0";"null";"null";"0.9444444444444444";"0.05555555555555555";"0.9444444444444444";"0.05555555555555555";"0.3333333333333333";"0.6666666666666666";"0.0";"1"
"213451";"Richard Phillips";"201";"200";"1";"200";"1";"196";"5";"0";"null";"null";"0.9950248756218906";"0.004975124378109453";"0.9950248756218906";"0.004975124378109453";"0.9751243781094527";"0.024875621890547265";"0.0";"2"
"4964739";"Panc Bike";"3";"2";"1";"2";"1";"3";"0";"0";"null";"null";"0.6666666666666666";"0.3333333333333333";"0.6666666666666666";"0.3333333333333333";"1.0";"0.0";"0.0";"1"
"2896356";"Joseph Renzi";"16";"0";"16";"15";"1";"16";"0";"0";"null";"null";"0.0";"1.0";"0.9375";"0.0625";"1.0";"0.0";"0.0";"1"
"2884070";"ARCK9Kathy";"33";"0";"33";"32";"1";"32";"1";"0";"null";"null";"0.0";"1.0";"0.9696969696969697";"0.030303030303030304";"0.9696969696969697";"0.030303030303030304";"0.0";"3"
"4350345";"Saurav_shrestha";"4";"3";"1";"3";"1";"4";"0";"0";"null";"null";"0.75";"0.25";"0.75";"0.25";"1.0";"0.0";"0.0";"1"
"2896353";"Aashish Bhattarai";"18";"0";"18";"17";"1";"18";"0";"0";"null";"null";"0.0";"1.0";"0.9444444444444444";"0.05555555555555555";"1.0";"0.0";"0.0";"2"
"2871782";"BernaWang";"1";"0";"1";"0";"1";"1";"0";"0";"null";"null";"0.0";"1.0";"0.0";"1.0";"1.0";"0.0";"0.0";"1"
"2904546";"Janaks";"5";"0";"5";"0";"5";"1";"4";"2";"null";"null";"0.0";"1.0";"0.0";"1.0";"0.2";"0.8";"0.4";"2"
"4456861";"सुशिल कठेत";"3";"1";"2";"2";"1";"3";"0";"0";"null";"null";"0.3333333333333333";"0.6666666666666666";"0.6666666666666666";"0.3333333333333333";"1.0";"0.0";"0.0";"3"
"4526490";"Callisto Himal Khadka";"1";"0";"1";"0";"1";"1";"0";"0";"null";"null";"0.0";"1.0";"0.0";"1.0";"1.0";"0.0";"0.0";"1"
"1962477";"jc67";"1";"0";"1";"0";"1";"0";"1";"0";"null";"null";"0.0";"1.0";"0.0";"1.0";"0.0";"1.0";"0.0";"1"
"4809149";"Sandip Joshi";"1";"0";"1";"0";"1";"1";"0";"0";"null";"null";"0.0";"1.0";"0.0";"1.0";"1.0";"0.0";"0.0";"1"
"4039113";"Ashish Thapa";"8";"0";"8";"7";"1";"8";"0";"0";"null";"null";"0.0";"1.0";"0.875";"0.125";"1.0";"0.0";"0.0";"1"
"2871775";"cjlavery";"5";"0";"5";"4";"1";"5";"0";"0";"null";"null";"0.0";"1.0";"0.8";"0.2";"1.0";"0.0";"0.0";"2"
"1704472";"Emmanuel Bama";"116";"0";"116";"0";"116";"116";"0";"0";"null";"null";"0.0";"1.0";"0.0";"1.0";"1.0";"0.0";"0.0";"8"
"61955";"moaxey";"1";"0";"1";"0";"1";"1";"0";"0";"null";"null";"0.0";"1.0";"0.0";"1.0";"1.0";"0.0";"0.0";"1"
"2359841";"StayGold";"563";"71";"492";"562";"1";"545";"18";"12";"null";"null";"0.1261101243339254";"0.8738898756660746";"0.9982238010657194";"0.0017761989342806395";"0.9680284191829485";"0.03197158081705151";"0.021314387211367674";"10"
"1663504";"FofB";"82";"81";"1";"0";"82";"68";"14";"6";"null";"null";"0.9878048780487805";"0.012195121951219513";"0.0";"1.0";"0.8292682926829268";"0.17073170731707318";"0.07317073170731707";"1"
"1806864";"blickieluk";"67";"0";"67";"66";"1";"67";"0";"0";"null";"null";"0.0";"1.0";"0.9850746268656716";"0.014925373134328358";"1.0";"0.0";"0.0";"1"
"2867744";"GS15";"11";"0";"11";"10";"1";"11";"0";"0";"null";"null";"0.0";"1.0";"0.9090909090909091";"0.09090909090909091";"1.0";"0.0";"0.0";"1"
"2859559";"Ma Mo";"146";"0";"146";"0";"146";"146";"0";"0";"null";"null";"0.0";"1.0";"0.0";"1.0";"1.0";"0.0";"0.0";"13"
"3490360";"Srijit Sharma";"5";"0";"5";"4";"1";"5";"0";"0";"null";"null";"0.0";"1.0";"0.8";"0.2";"1.0";"0.0";"0.0";"1"
"86545";"synchron";"116";"0";"116";"115";"1";"116";"0";"0";"null";"null";"0.0";"1.0";"0.9913793103448276";"0.008620689655172414";"1.0";"0.0";"0.0";"6"
"3568162";"Raul Shk";"3";"2";"1";"0";"3";"3";"0";"0";"null";"null";"0.6666666666666666";"0.3333333333333333";"0.0";"1.0";"1.0";"0.0";"0.0";"2"
"524831";"fmoine";"853";"738";"115";"852";"1";"217";"636";"580";"null";"null";"0.8651817116060961";"0.13481828839390386";"0.9988276670574443";"0.0011723329425556857";"0.2543962485345838";"0.7456037514654161";"0.6799531066822978";"39"
"2904635";"stevetulowiecki";"95";"0";"95";"0";"95";"87";"8";"6";"null";"null";"0.0";"1.0";"0.0";"1.0";"0.9157894736842105";"0.08421052631578947";"0.06315789473684211";"19"
"4883026";"Nahoh Nepal";"1";"0";"1";"0";"1";"1";"0";"0";"null";"null";"0.0";"1.0";"0.0";"1.0";"1.0";"0.0";"0.0";"1"
"2859570";"meghanhayes";"65";"0";"65";"0";"65";"65";"0";"0";"null";"null";"0.0";"1.0";"0.0";"1.0";"1.0";"0.0";"0.0";"3"
"2871862";"lmawhinney";"6";"0";"6";"0";"6";"6";"0";"0";"null";"null";"0.0";"1.0";"0.0";"1.0";"1.0";"0.0";"0.0";"1"
"3944984";"Shreedhar Singh";"6";"5";"1";"0";"6";"5";"1";"0";"null";"null";"0.8333333333333334";"0.16666666666666666";"0.0";"1.0";"0.8333333333333334";"0.16666666666666666";"0.0";"2"
"549422";"l-ambda";"381";"0";"381";"380";"1";"379";"2";"1";"null";"null";"0.0";"1.0";"0.9973753280839895";"0.0026246719160104987";"0.994750656167979";"0.005249343832020997";"0.0026246719160104987";"3"
"3383835";"Bishwash Poudel";"6";"5";"1";"5";"1";"6";"0";"0";"null";"null";"0.8333333333333334";"0.16666666666666666";"0.8333333333333334";"0.16666666666666666";"1.0";"0.0";"0.0";"1"
"2052661";"Prawchan";"215";"214";"1";"214";"1";"99";"116";"107";"null";"null";"0.9953488372093023";"0.004651162790697674";"0.9953488372093023";"0.004651162790697674";"0.4604651162790698";"0.5395348837209303";"0.49767441860465117";"3"
"2884097";"pradhyu";"96";"0";"96";"0";"96";"37";"59";"38";"null";"null";"0.0";"1.0";"0.0";"1.0";"0.3854166666666667";"0.6145833333333334";"0.3958333333333333";"1"
"361003";"Cascafico";"8";"7";"1";"7";"1";"8";"0";"0";"null";"null";"0.875";"0.125";"0.875";"0.125";"1.0";"0.0";"0.0";"1"
"4186637";"Himal Simkhada";"2";"0";"2";"1";"1";"2";"0";"0";"null";"null";"0.0";"1.0";"0.5";"0.5";"1.0";"0.0";"0.0";"2"
"4641396";"RITESH007";"1";"0";"1";"0";"1";"1";"0";"0";"null";"null";"0.0";"1.0";"0.0";"1.0";"1.0";"0.0";"0.0";"1"
"999995";"pkoby";"270";"0";"270";"269";"1";"269";"1";"0";"null";"null";"0.0";"1.0";"0.9962962962962963";"0.003703703703703704";"0.9962962962962963";"0.003703703703703704";"0.0";"2"
"2880019";"Fernando Cruz";"9";"8";"1";"8";"1";"5";"4";"4";"null";"null";"0.8888888888888888";"0.1111111111111111";"0.8888888888888888";"0.1111111111111111";"0.5555555555555556";"0.4444444444444444";"0.4444444444444444";"1"
"4694652";"Teafresho";"3";"1";"2";"1";"2";"3";"0";"0";"null";"null";"0.3333333333333333";"0.6666666666666666";"0.3333333333333333";"0.6666666666666666";"1.0";"0.0";"0.0";"3"
"3781122";"Mandish Maharjan";"1";"0";"1";"0";"1";"1";"0";"0";"null";"null";"0.0";"1.0";"0.0";"1.0";"1.0";"0.0";"0.0";"1"
"4088322";"Amol Acharya";"1";"0";"1";"0";"1";"1";"0";"0";"null";"null";"0.0";"1.0";"0.0";"1.0";"1.0";"0.0";"0.0";"1"
"98876";"rsoden";"11";"10";"1";"10";"1";"6";"5";"3";"null";"null";"0.9090909090909091";"0.09090909090909091";"0.9090909090909091";"0.09090909090909091";"0.5454545454545454";"0.45454545454545453";"0.2727272727272727";"1"
"2876011";"synap";"264";"18";"246";"263";"1";"254";"10";"1";"null";"null";"0.06818181818181818";"0.9318181818181818";"0.9962121212121212";"0.003787878787878788";"0.9621212121212122";"0.03787878787878788";"0.003787878787878788";"15"
"4518405";"Bishnu Thapa";"7";"4";"3";"4";"3";"5";"2";"0";"null";"null";"0.5714285714285714";"0.42857142857142855";"0.5714285714285714";"0.42857142857142855";"0.7142857142857143";"0.2857142857142857";"0.0";"6"
"2843241";"shioriko";"778";"544";"234";"777";"1";"757";"21";"18";"null";"null";"0.699228791773779";"0.30077120822622105";"0.9987146529562982";"0.0012853470437017994";"0.9730077120822622";"0.02699228791773779";"0.02313624678663239";"23"
"2880105";"ngawang";"23";"0";"23";"22";"1";"6";"17";"16";"null";"null";"0.0";"1.0";"0.9565217391304348";"0.043478260869565216";"0.2608695652173913";"0.7391304347826086";"0.6956521739130435";"1"
"1069655";"Milli1201";"17";"16";"1";"16";"1";"0";"17";"0";"null";"null";"0.9411764705882353";"0.058823529411764705";"0.9411764705882353";"0.058823529411764705";"0.0";"1.0";"0.0";"3"
"2888295";"PaulinePanda";"5";"0";"5";"4";"1";"5";"0";"0";"null";"null";"0.0";"1.0";"0.8";"0.2";"1.0";"0.0";"0.0";"2"
"369227";"wikiosm";"13";"0";"13";"12";"1";"13";"0";"0";"null";"null";"0.0";"1.0";"0.9230769230769231";"0.07692307692307693";"1.0";"0.0";"0.0";"3"
"2880101";"Avivtech";"12";"0";"12";"11";"1";"4";"8";"0";"null";"null";"0.0";"1.0";"0.9166666666666666";"0.08333333333333333";"0.3333333333333333";"0.6666666666666666";"0.0";"2"
"1585736";"noble_akonu";"781";"289";"492";"0";"781";"402";"379";"110";"null";"null";"0.3700384122919334";"0.6299615877080665";"0.0";"1.0";"0.5147247119078106";"0.4852752880921895";"0.14084507042253522";"7"
"3388003";"Snow Leopard";"24";"23";"1";"0";"24";"12";"12";"2";"null";"null";"0.9583333333333334";"0.041666666666666664";"0.0";"1.0";"0.5";"0.5";"0.08333333333333333";"9"
"606809";"llorban";"19";"0";"19";"18";"1";"19";"0";"0";"null";"null";"0.0";"1.0";"0.9473684210526315";"0.05263157894736842";"1.0";"0.0";"0.0";"1"
"2871930";"roshan213";"39";"0";"39";"38";"1";"19";"20";"0";"null";"null";"0.0";"1.0";"0.9743589743589743";"0.02564102564102564";"0.48717948717948717";"0.5128205128205128";"0.0";"2"
"1872461";"SBassett";"12";"11";"1";"11";"1";"12";"0";"0";"null";"null";"0.9166666666666666";"0.08333333333333333";"0.9166666666666666";"0.08333333333333333";"1.0";"0.0";"0.0";"1"
"139856";"redsteakraw";"346";"0";"346";"345";"1";"345";"1";"0";"null";"null";"0.0";"1.0";"0.9971098265895953";"0.002890173410404624";"0.9971098265895953";"0.002890173410404624";"0.0";"1"
"4887069";"Lekha Nath khatiwada";"1";"0";"1";"0";"1";"1";"0";"0";"null";"null";"0.0";"1.0";"0.0";"1.0";"1.0";"0.0";"0.0";"1"
"2843249";"shimoo";"528";"288";"240";"527";"1";"528";"0";"0";"null";"null";"0.5454545454545454";"0.45454545454545453";"0.9981060606060606";"0.001893939393939394";"1.0";"0.0";"0.0";"4"
"2843248";"Taka1012";"170";"169";"1";"169";"1";"149";"21";"15";"null";"null";"0.9941176470588236";"0.0058823529411764705";"0.9941176470588236";"0.0058823529411764705";"0.8764705882352941";"0.12352941176470589";"0.08823529411764706";"8"
"3215978";"नेपाली फूटबल प्रेमी";"43";"42";"1";"0";"43";"42";"1";"0";"null";"null";"0.9767441860465116";"0.023255813953488372";"0.0";"1.0";"0.9767441860465116";"0.023255813953488372";"0.0";"3"
"2843254";"NATSUMI";"1610";"575";"1035";"1609";"1";"1608";"2";"0";"null";"null";"0.35714285714285715";"0.6428571428571429";"0.9993788819875776";"6.211180124223603E-4";"0.9987577639751553";"0.0012422360248447205";"0.0";"288"
"4887060";"Kamal Bista";"4";"3";"1";"0";"4";"4";"0";"0";"null";"null";"0.75";"0.25";"0.0";"1.0";"1.0";"0.0";"0.0";"1"
"2880117";"dminovi";"2";"0";"2";"1";"1";"0";"2";"0";"null";"null";"0.0";"1.0";"0.5";"0.5";"0.0";"1.0";"0.0";"1"
"2052672";"ramkhoju";"16";"0";"16";"15";"1";"0";"16";"4";"null";"null";"0.0";"1.0";"0.9375";"0.0625";"0.0";"1.0";"0.25";"1"
"1704570";"bosman542";"14";"0";"14";"13";"1";"0";"14";"6";"null";"null";"0.0";"1.0";"0.9285714285714286";"0.07142857142857142";"0.0";"1.0";"0.42857142857142855";"1"
"1852029";"smaprs";"197";"0";"197";"196";"1";"193";"4";"0";"null";"null";"0.0";"1.0";"0.9949238578680203";"0.005076142131979695";"0.9796954314720813";"0.02030456852791878";"0.0";"2"
"4698662";"Diwakar Pandey";"1";"0";"1";"0";"1";"1";"0";"0";"null";"null";"0.0";"1.0";"0.0";"1.0";"1.0";"0.0";"0.0";"1"
"2875976";"AimoInUSA";"30";"0";"30";"29";"1";"14";"16";"0";"null";"null";"0.0";"1.0";"0.9666666666666667";"0.03333333333333333";"0.4666666666666667";"0.5333333333333333";"0.0";"4"
"1159797";"hellopratap";"1";"0";"1";"0";"1";"1";"0";"0";"null";"null";"0.0";"1.0";"0.0";"1.0";"1.0";"0.0";"0.0";"1"
"1823346";"user_1823346";"1";"0";"1";"0";"1";"0";"1";"0";"null";"null";"0.0";"1.0";"0.0";"1.0";"0.0";"1.0";"0.0";"1"
"2880064";"Casas01";"8";"0";"8";"7";"1";"8";"0";"0";"null";"null";"0.0";"1.0";"0.875";"0.125";"1.0";"0.0";"0.0";"1"
"62061";"mcyc";"211";"0";"211";"210";"1";"181";"30";"9";"null";"null";"0.0";"1.0";"0.995260663507109";"0.004739336492890996";"0.8578199052132701";"0.14218009478672985";"0.04265402843601896";"28"
"2867781";"deeptrees";"3";"0";"3";"2";"1";"3";"0";"0";"null";"null";"0.0";"1.0";"0.6666666666666666";"0.3333333333333333";"1.0";"0.0";"0.0";"1"
"2871898";"Nicolas3103";"4";"0";"4";"3";"1";"4";"0";"0";"null";"null";"0.0";"1.0";"0.75";"0.25";"1.0";"0.0";"0.0";"1"
"1225312";"Kathyaus";"186";"0";"186";"0";"186";"25";"161";"59";"null";"null";"0.0";"1.0";"0.0";"1.0";"0.13440860215053763";"0.8655913978494624";"0.3172043010752688";"1"
"4866617";"Binij";"1";"0";"1";"0";"1";"1";"0";"0";"null";"null";"0.0";"1.0";"0.0";"1.0";"1.0";"0.0";"0.0";"1"
"2863702";"Sarah Bindman";"87";"0";"87";"86";"1";"87";"0";"0";"null";"null";"0.0";"1.0";"0.9885057471264368";"0.011494252873563218";"1.0";"0.0";"0.0";"1"
"2880085";"Richard Chim";"9";"0";"9";"8";"1";"9";"0";"0";"null";"null";"0.0";"1.0";"0.8888888888888888";"0.1111111111111111";"1.0";"0.0";"0.0";"1"
"2175648";"Emmece";"3324";"1707";"1617";"3253";"71";"1675";"1649";"168";"null";"null";"0.5135379061371841";"0.48646209386281586";"0.9786401925391095";"0.021359807460890494";"0.5039109506618532";"0.4960890493381468";"0.05054151624548736";"69"
"2859689";"jleal";"896";"0";"896";"0";"896";"864";"32";"4";"null";"null";"0.0";"1.0";"0.0";"1.0";"0.9642857142857143";"0.03571428571428571";"0.004464285714285714";"10"
"4068028";"om shrestha";"1";"0";"1";"0";"1";"1";"0";"0";"null";"null";"0.0";"1.0";"0.0";"1.0";"1.0";"0.0";"0.0";"1"
"2650797";"AyushB";"8";"0";"8";"7";"1";"4";"4";"0";"null";"null";"0.0";"1.0";"0.875";"0.125";"0.5";"0.5";"0.0";"2"
"29320";"Komяpa";"1";"0";"1";"0";"1";"0";"1";"0";"null";"null";"0.0";"1.0";"0.0";"1.0";"0.0";"1.0";"0.0";"1"
"201359";"wambacher";"42";"41";"1";"41";"1";"12";"30";"12";"null";"null";"0.9761904761904762";"0.023809523809523808";"0.9761904761904762";"0.023809523809523808";"0.2857142857142857";"0.7142857142857143";"0.2857142857142857";"1"
"2871973";"KVita";"6";"0";"6";"5";"1";"6";"0";"0";"null";"null";"0.0";"1.0";"0.8333333333333334";"0.16666666666666666";"1.0";"0.0";"0.0";"1"
"4850373";"NepaliKiwi";"19";"0";"19";"18";"1";"19";"0";"0";"null";"null";"0.0";"1.0";"0.9473684210526315";"0.05263157894736842";"1.0";"0.0";"0.0";"1"
"4301521";"BhandariAmir";"15";"14";"1";"14";"1";"15";"0";"0";"null";"null";"0.9333333333333333";"0.06666666666666667";"0.9333333333333333";"0.06666666666666667";"1.0";"0.0";"0.0";"1"
"2859698";"assanges";"53";"0";"53";"0";"53";"53";"0";"0";"null";"null";"0.0";"1.0";"0.0";"1.0";"1.0";"0.0";"0.0";"1"
"2306749";"shvrm";"143";"0";"143";"142";"1";"135";"8";"0";"null";"null";"0.0";"1.0";"0.993006993006993";"0.006993006993006993";"0.9440559440559441";"0.055944055944055944";"0.0";"2"
"2880181";"Betzilla";"20";"0";"20";"19";"1";"16";"4";"4";"null";"null";"0.0";"1.0";"0.95";"0.05";"0.8";"0.2";"0.2";"1"
"4784855";"sanjog maharjan";"1";"0";"1";"0";"1";"1";"0";"0";"null";"null";"0.0";"1.0";"0.0";"1.0";"1.0";"0.0";"0.0";"1"
"3859096";"Heerak";"1";"0";"1";"0";"1";"0";"1";"0";"null";"null";"0.0";"1.0";"0.0";"1.0";"0.0";"1.0";"0.0";"1"
"3478167";"SBimochan";"2";"1";"1";"1";"1";"2";"0";"0";"null";"null";"0.5";"0.5";"0.5";"0.5";"1.0";"0.0";"0.0";"2"
"709289";"Super-Map";"296";"0";"296";"295";"1";"293";"3";"0";"null";"null";"0.0";"1.0";"0.9966216216216216";"0.0033783783783783786";"0.9898648648648649";"0.010135135135135136";"0.0";"1"
"3973784";"rraj gautam";"4";"2";"2";"3";"1";"4";"0";"0";"null";"null";"0.5";"0.5";"0.75";"0.25";"1.0";"0.0";"0.0";"3"
"2871949";"rpaudel";"13";"0";"13";"12";"1";"13";"0";"0";"null";"null";"0.0";"1.0";"0.9230769230769231";"0.07692307692307693";"1.0";"0.0";"0.0";"3"
"2843266";"wataharu4";"482";"208";"274";"481";"1";"482";"0";"0";"null";"null";"0.4315352697095436";"0.5684647302904564";"0.9979253112033195";"0.002074688796680498";"1.0";"0.0";"0.0";"82"
"4748002";"Bijay Sapkota";"2";"0";"2";"1";"1";"2";"0";"0";"null";"null";"0.0";"1.0";"0.5";"0.5";"1.0";"0.0";"0.0";"2"
"37548";"Marcussacapuces91";"72";"71";"1";"71";"1";"41";"31";"6";"null";"null";"0.9861111111111112";"0.013888888888888888";"0.9861111111111112";"0.013888888888888888";"0.5694444444444444";"0.4305555555555556";"0.08333333333333333";"1"
"3388062";"Karnali";"6";"5";"1";"0";"6";"6";"0";"0";"null";"null";"0.8333333333333334";"0.16666666666666666";"0.0";"1.0";"1.0";"0.0";"0.0";"2"
"4731622";"madhavchy123";"1";"0";"1";"0";"1";"1";"0";"0";"null";"null";"0.0";"1.0";"0.0";"1.0";"1.0";"0.0";"0.0";"1"
"4862692";"Bishow333";"1";"0";"1";"0";"1";"1";"0";"0";"null";"null";"0.0";"1.0";"0.0";"1.0";"1.0";"0.0";"0.0";"1"
"2863771";"chanonyi";"3";"0";"3";"2";"1";"2";"1";"0";"null";"null";"0.0";"1.0";"0.6666666666666666";"0.3333333333333333";"0.6666666666666666";"0.3333333333333333";"0.0";"2"
"2884253";"SmartyPantas";"292";"0";"292";"0";"292";"288";"4";"4";"null";"null";"0.0";"1.0";"0.0";"1.0";"0.9863013698630136";"0.0136986301369863";"0.0136986301369863";"3"
"2871960";"sujanadh";"7";"0";"7";"6";"1";"6";"1";"0";"null";"null";"0.0";"1.0";"0.8571428571428571";"0.14285714285714285";"0.8571428571428571";"0.14285714285714285";"0.0";"3"
"3687052";"rrp12";"13";"12";"1";"0";"13";"5";"8";"1";"null";"null";"0.9230769230769231";"0.07692307692307693";"0.0";"1.0";"0.38461538461538464";"0.6153846153846154";"0.07692307692307693";"4"
"1979051";"Panday's Paradise";"5";"4";"1";"4";"1";"0";"5";"0";"null";"null";"0.8";"0.2";"0.8";"0.2";"0.0";"1.0";"0.0";"1"
"5047031";"Ųňįqūə Đəępëñ";"1";"0";"1";"0";"1";"1";"0";"0";"null";"null";"0.0";"1.0";"0.0";"1.0";"1.0";"0.0";"0.0";"1"
"1315496";"archanakc";"4";"0";"4";"3";"1";"4";"0";"0";"null";"null";"0.0";"1.0";"0.75";"0.25";"1.0";"0.0";"0.0";"1"
"2876053";"Heyok1";"23";"22";"1";"22";"1";"23";"0";"0";"null";"null";"0.9565217391304348";"0.043478260869565216";"0.9565217391304348";"0.043478260869565216";"1.0";"0.0";"0.0";"1"
"3117712";"mount fuji home";"5";"4";"1";"4";"1";"2";"3";"1";"null";"null";"0.8";"0.2";"0.8";"0.2";"0.4";"0.6";"0.2";"3"
"2540262";"dpka";"18";"17";"1";"0";"18";"16";"2";"0";"null";"null";"0.9444444444444444";"0.05555555555555555";"0.0";"1.0";"0.8888888888888888";"0.1111111111111111";"0.0";"12"
"2888428";"TRB Surveyors";"33";"32";"1";"32";"1";"33";"0";"0";"null";"null";"0.9696969696969697";"0.030303030303030304";"0.9696969696969697";"0.030303030303030304";"1.0";"0.0";"0.0";"1"
"2540263";"Amit Maharjan";"70";"69";"1";"0";"70";"68";"2";"1";"null";"null";"0.9857142857142858";"0.014285714285714285";"0.0";"1.0";"0.9714285714285714";"0.02857142857142857";"0.014285714285714285";"13"
"4563584";"Rohitunited";"19";"0";"19";"18";"1";"15";"4";"0";"null";"null";"0.0";"1.0";"0.9473684210526315";"0.05263157894736842";"0.7894736842105263";"0.21052631578947367";"0.0";"1"
"1209047";"Tsunami Nabin";"1";"0";"1";"0";"1";"0";"1";"0";"null";"null";"0.0";"1.0";"0.0";"1.0";"0.0";"1.0";"0.0";"1"
"2097893";"Bipin Parajuli";"31";"11";"20";"30";"1";"30";"1";"1";"null";"null";"0.3548387096774194";"0.6451612903225806";"0.967741935483871";"0.03225806451612903";"0.967741935483871";"0.03225806451612903";"0.03225806451612903";"3"
"4563587";"sophin";"43";"0";"43";"42";"1";"19";"24";"0";"null";"null";"0.0";"1.0";"0.9767441860465116";"0.023255813953488372";"0.4418604651162791";"0.5581395348837209";"0.0";"1"
"352975";"Bijay Dewan";"1";"0";"1";"0";"1";"1";"0";"0";"null";"null";"0.0";"1.0";"0.0";"1.0";"1.0";"0.0";"0.0";"1"
"3883761";"Mrzan Razesh";"2";"0";"2";"1";"1";"2";"0";"0";"null";"null";"0.0";"1.0";"0.5";"0.5";"1.0";"0.0";"0.0";"2"
"2880224";"RachSymonds";"1";"0";"1";"0";"1";"0";"1";"0";"null";"null";"0.0";"1.0";"0.0";"1.0";"0.0";"1.0";"0.0";"1"
"4506248";"ajjoshi092";"1";"0";"1";"0";"1";"1";"0";"0";"null";"null";"0.0";"1.0";"0.0";"1.0";"1.0";"0.0";"0.0";"1"
"4563594";"Saurab";"1";"0";"1";"0";"1";"0";"1";"0";"null";"null";"0.0";"1.0";"0.0";"1.0";"0.0";"1.0";"0.0";"1"
"4559498";"Sajin Shahi";"1";"0";"1";"0";"1";"1";"0";"0";"null";"null";"0.0";"1.0";"0.0";"1.0";"1.0";"0.0";"0.0";"1"
"4395667";"hikp";"7";"5";"2";"5";"2";"0";"7";"0";"null";"null";"0.7142857142857143";"0.2857142857142857";"0.7142857142857143";"0.2857142857142857";"0.0";"1.0";"0.0";"7"
"4563604";"mrfaceless";"30";"0";"30";"29";"1";"29";"1";"1";"null";"null";"0.0";"1.0";"0.9666666666666667";"0.03333333333333333";"0.9666666666666667";"0.03333333333333333";"0.03333333333333333";"3"
"2540277";"razzancha";"17";"16";"1";"7";"10";"12";"5";"0";"null";"null";"0.9411764705882353";"0.058823529411764705";"0.4117647058823529";"0.5882352941176471";"0.7058823529411765";"0.29411764705882354";"0.0";"5"
"504532";"bikash";"8";"7";"1";"7";"1";"0";"8";"0";"null";"null";"0.875";"0.125";"0.875";"0.125";"0.0";"1.0";"0.0";"1"
"4268697";"Tatiana  Savostyanova";"1";"0";"1";"0";"1";"1";"0";"0";"null";"null";"0.0";"1.0";"0.0";"1.0";"1.0";"0.0";"0.0";"1"
"2908917";"RandM";"440";"0";"440";"439";"1";"315";"125";"29";"null";"null";"0.0";"1.0";"0.9977272727272727";"0.0022727272727272726";"0.7159090909090909";"0.2840909090909091";"0.0659090909090909";"20"
"4911765";"रिमाल बि पी";"1";"0";"1";"0";"1";"1";"0";"0";"null";"null";"0.0";"1.0";"0.0";"1.0";"1.0";"0.0";"0.0";"1"
"2900685";"aseempoudel";"2";"0";"2";"1";"1";"1";"1";"0";"null";"null";"0.0";"1.0";"0.5";"0.5";"0.5";"0.5";"0.0";"1"
"152289";"cgu66";"10";"4";"6";"8";"2";"0";"10";"0";"null";"null";"0.4";"0.6";"0.8";"0.2";"0.0";"1.0";"0.0";"7"
"516835";"doledechu";"733";"732";"1";"0";"733";"622";"111";"53";"null";"null";"0.9986357435197817";"0.001364256480218281";"0.0";"1.0";"0.8485675306957708";"0.15143246930422918";"0.0723055934515689";"1"
"2859725";"Pravindngl";"96";"0";"96";"0";"96";"96";"0";"0";"null";"null";"0.0";"1.0";"0.0";"1.0";"1.0";"0.0";"0.0";"4"
"2343621";"Ram Rohan Panta";"1";"0";"1";"0";"1";"0";"1";"1";"null";"null";"0.0";"1.0";"0.0";"1.0";"0.0";"1.0";"1.0";"1"
"2986698";"Sue Scull";"94";"0";"94";"93";"1";"94";"0";"0";"null";"null";"0.0";"1.0";"0.9893617021276596";"0.010638297872340425";"1.0";"0.0";"0.0";"1"
"2163401";"Broiler16";"3";"2";"1";"2";"1";"3";"0";"0";"null";"null";"0.6666666666666666";"0.3333333333333333";"0.6666666666666666";"0.3333333333333333";"1.0";"0.0";"0.0";"1"
"4051669";"loconvey";"1";"0";"1";"0";"1";"0";"1";"0";"null";"null";"0.0";"1.0";"0.0";"1.0";"0.0";"1.0";"0.0";"1"
"2908864";"Team_Dobby";"6";"5";"1";"5";"1";"6";"0";"0";"null";"null";"0.8333333333333334";"0.16666666666666666";"0.8333333333333334";"0.16666666666666666";"1.0";"0.0";"0.0";"1"
"3642073";"user411";"1";"0";"1";"0";"1";"0";"1";"0";"null";"null";"0.0";"1.0";"0.0";"1.0";"0.0";"1.0";"0.0";"1"
"107257";"FrViPofm";"13";"0";"13";"12";"1";"0";"13";"1";"null";"null";"0.0";"1.0";"0.9230769230769231";"0.07692307692307693";"0.0";"1.0";"0.07692307692307693";"1"
"1884900";"quantumwell";"79";"0";"79";"78";"1";"56";"23";"18";"null";"null";"0.0";"1.0";"0.9873417721518988";"0.012658227848101266";"0.7088607594936709";"0.2911392405063291";"0.22784810126582278";"1"
"2876115";"sgrimes";"26";"0";"26";"25";"1";"24";"2";"0";"null";"null";"0.0";"1.0";"0.9615384615384616";"0.038461538461538464";"0.9230769230769231";"0.07692307692307693";"0.0";"5"
"2822866";"Nepal Tours";"1";"0";"1";"0";"1";"1";"0";"0";"null";"null";"0.0";"1.0";"0.0";"1.0";"1.0";"0.0";"0.0";"1"
"2634451";"ppoudel77";"2";"0";"2";"1";"1";"0";"2";"0";"null";"null";"0.0";"1.0";"0.5";"0.5";"0.0";"1.0";"0.0";"1"
"443130";"Alan Bragg";"538";"0";"538";"537";"1";"163";"375";"47";"null";"null";"0.0";"1.0";"0.9981412639405205";"0.0018587360594795538";"0.30297397769516726";"0.6970260223048327";"0.08736059479553904";"2"
"4305597";"Subas Panthi";"2";"0";"2";"0";"2";"1";"1";"0";"null";"null";"0.0";"1.0";"0.0";"1.0";"0.5";"0.5";"0.0";"2"
"2917075";"elpictopinto";"82";"81";"1";"81";"1";"82";"0";"0";"null";"null";"0.9878048780487805";"0.012195121951219513";"0.9878048780487805";"0.012195121951219513";"1.0";"0.0";"0.0";"3"
"4957002";"Deepak lamichhane";"1";"0";"1";"0";"1";"1";"0";"0";"null";"null";"0.0";"1.0";"0.0";"1.0";"1.0";"0.0";"0.0";"1"
"4363079";"Eklo Yatri";"4";"0";"4";"0";"4";"3";"1";"0";"null";"null";"0.0";"1.0";"0.0";"1.0";"0.75";"0.25";"0.0";"1"
"2548512";"Johnprof@Ayiyikoh";"1479";"0";"1479";"0";"1479";"1466";"13";"0";"null";"null";"0.0";"1.0";"0.0";"1.0";"0.991210277214334";"0.00878972278566599";"0.0";"2"
"3924797";"Sushil Thapa";"2";"0";"2";"1";"1";"2";"0";"0";"null";"null";"0.0";"1.0";"0.5";"0.5";"1.0";"0.0";"0.0";"2"
"2868012";"Sambridi Gautam";"8";"0";"8";"7";"1";"8";"0";"0";"null";"null";"0.0";"1.0";"0.875";"0.125";"1.0";"0.0";"0.0";"2"
"1843988";"Skipper_is";"669";"0";"669";"668";"1";"667";"2";"0";"null";"null";"0.0";"1.0";"0.9985052316890882";"0.0014947683109118087";"0.9970104633781763";"0.0029895366218236174";"0.0";"13"
"4932419";"Alekxo";"2";"1";"1";"1";"1";"0";"2";"1";"null";"null";"0.5";"0.5";"0.5";"0.5";"0.0";"1.0";"0.5";"1"
"4916038";"Dinesh Thakali";"2";"0";"2";"1";"1";"1";"1";"0";"null";"null";"0.0";"1.0";"0.5";"0.5";"0.5";"0.5";"0.0";"1"
"2884386";"annie861220";"47";"0";"47";"0";"47";"47";"0";"0";"null";"null";"0.0";"1.0";"0.0";"1.0";"1.0";"0.0";"0.0";"1"
"4457300";"Dipesh Sakya";"1";"0";"1";"0";"1";"1";"0";"0";"null";"null";"0.0";"1.0";"0.0";"1.0";"1.0";"0.0";"0.0";"1"
"2892604";"bickrant";"1";"0";"1";"0";"1";"1";"0";"0";"null";"null";"0.0";"1.0";"0.0";"1.0";"1.0";"0.0";"0.0";"1"
"2331443";"Naseeb Shrestha";"5";"0";"5";"4";"1";"5";"0";"0";"null";"null";"0.0";"1.0";"0.8";"0.2";"1.0";"0.0";"0.0";"1"
"4354906";"cham11ng";"7";"5";"2";"6";"1";"5";"2";"0";"null";"null";"0.7142857142857143";"0.2857142857142857";"0.8571428571428571";"0.14285714285714285";"0.7142857142857143";"0.2857142857142857";"0.0";"6"
"4232032";"Rajesh Kumar Sah";"1";"0";"1";"0";"1";"1";"0";"0";"null";"null";"0.0";"1.0";"0.0";"1.0";"1.0";"0.0";"0.0";"1"
"2540295";"Binay Maharjan";"12";"11";"1";"0";"12";"10";"2";"0";"null";"null";"0.9166666666666666";"0.08333333333333333";"0.0";"1.0";"0.8333333333333334";"0.16666666666666666";"0.0";"5"
"1794878";"nebelwüste";"694";"389";"305";"693";"1";"694";"0";"0";"null";"null";"0.5605187319884726";"0.43948126801152737";"0.9985590778097982";"0.001440922190201729";"1.0";"0.0";"0.0";"10"
"3543827";"Pawan Gyawali";"2";"0";"2";"1";"1";"0";"2";"0";"null";"null";"0.0";"1.0";"0.5";"0.5";"0.0";"1.0";"0.0";"1"
"2908933";"Keiler Mark";"55";"38";"17";"54";"1";"53";"2";"1";"null";"null";"0.6909090909090909";"0.3090909090909091";"0.9818181818181818";"0.01818181818181818";"0.9636363636363636";"0.03636363636363636";"0.01818181818181818";"15"
"3416863";"Visual line Optical & Eye Clinic";"29";"0";"29";"28";"1";"7";"22";"9";"null";"null";"0.0";"1.0";"0.9655172413793104";"0.034482758620689655";"0.2413793103448276";"0.7586206896551724";"0.3103448275862069";"3"
"3199772";"pomstock";"1";"0";"1";"0";"1";"1";"0";"0";"null";"null";"0.0";"1.0";"0.0";"1.0";"1.0";"0.0";"0.0";"1"
"2908930";"MamaDearie";"10";"9";"1";"9";"1";"8";"2";"0";"null";"null";"0.9";"0.1";"0.9";"0.1";"0.8";"0.2";"0.0";"2"
"2880283";"jwlll";"2";"0";"2";"1";"1";"1";"1";"0";"null";"null";"0.0";"1.0";"0.5";"0.5";"0.5";"0.5";"0.0";"1"
"578362";"unknown365";"735";"734";"1";"734";"1";"728";"7";"0";"null";"null";"0.998639455782313";"0.0013605442176870747";"0.998639455782313";"0.0013605442176870747";"0.9904761904761905";"0.009523809523809525";"0.0";"2"
"4862840";"Padam Acharya";"1";"0";"1";"0";"1";"1";"0";"0";"null";"null";"0.0";"1.0";"0.0";"1.0";"1.0";"0.0";"0.0";"1"
"2876185";"Sanjog Bhatta";"3";"0";"3";"2";"1";"0";"3";"0";"null";"null";"0.0";"1.0";"0.6666666666666666";"0.3333333333333333";"0.0";"1.0";"0.0";"1"
"4158221";"Anita Paudel";"3";"0";"3";"2";"1";"3";"0";"0";"null";"null";"0.0";"1.0";"0.6666666666666666";"0.3333333333333333";"1.0";"0.0";"0.0";"2"
"2872089";"Sarah_Harley";"10";"0";"10";"9";"1";"10";"0";"0";"null";"null";"0.0";"1.0";"0.9";"0.1";"1.0";"0.0";"0.0";"1"
"2540309";"remixmhr";"7";"6";"1";"0";"7";"6";"1";"0";"null";"null";"0.8571428571428571";"0.14285714285714285";"0.0";"1.0";"0.8571428571428571";"0.14285714285714285";"0.0";"2"
"525117";"vtcraghead";"22";"0";"22";"21";"1";"10";"12";"10";"null";"null";"0.0";"1.0";"0.9545454545454546";"0.045454545454545456";"0.45454545454545453";"0.5454545454545454";"0.45454545454545453";"11"
"2859799";"technomage1";"10";"0";"10";"0";"10";"10";"0";"0";"null";"null";"0.0";"1.0";"0.0";"1.0";"1.0";"0.0";"0.0";"2"
"78656";"Walter Schlögl";"1";"0";"1";"0";"1";"0";"1";"0";"null";"null";"0.0";"1.0";"0.0";"1.0";"0.0";"1.0";"0.0";"1"
"49987";"Bakkegaard";"1";"0";"1";"0";"1";"1";"0";"0";"null";"null";"0.0";"1.0";"0.0";"1.0";"1.0";"0.0";"0.0";"1"
"2859887";"vargo";"11";"10";"1";"0";"11";"11";"0";"0";"null";"null";"0.9090909090909091";"0.09090909090909091";"0.0";"1.0";"1.0";"0.0";"0.0";"1"
"213831";"Josef73";"1";"0";"1";"0";"1";"0";"1";"0";"null";"null";"0.0";"1.0";"0.0";"1.0";"0.0";"1.0";"0.0";"1"
"2888553";"Ejesh";"5";"0";"5";"4";"1";"1";"4";"0";"null";"null";"0.0";"1.0";"0.8";"0.2";"0.2";"0.8";"0.0";"1"
"2057049";"humagai puskar";"7";"0";"7";"6";"1";"6";"1";"0";"null";"null";"0.0";"1.0";"0.8571428571428571";"0.14285714285714285";"0.8571428571428571";"0.14285714285714285";"0.0";"4"
"1901394";"JFayne";"6";"5";"1";"5";"1";"6";"0";"0";"null";"null";"0.8333333333333334";"0.16666666666666666";"0.8333333333333334";"0.16666666666666666";"1.0";"0.0";"0.0";"1"
"2524022";"Yugen Maharjan";"131";"130";"1";"0";"131";"103";"28";"24";"null";"null";"0.9923664122137404";"0.007633587786259542";"0.0";"1.0";"0.7862595419847328";"0.21374045801526717";"0.183206106870229";"16"
"4789017";"Sagar Bhandary";"2";"0";"2";"1";"1";"2";"0";"0";"null";"null";"0.0";"1.0";"0.5";"0.5";"1.0";"0.0";"0.0";"1"
"103253";"gormur";"2";"1";"1";"1";"1";"0";"2";"0";"null";"null";"0.5";"0.5";"0.5";"0.5";"0.0";"1.0";"0.0";"1"
"5042971";"Shree krishana Dhungana";"1";"0";"1";"0";"1";"1";"0";"0";"null";"null";"0.0";"1.0";"0.0";"1.0";"1.0";"0.0";"0.0";"1"
"1254219";"Niluja";"158";"0";"158";"157";"1";"147";"11";"10";"null";"null";"0.0";"1.0";"0.9936708860759493";"0.006329113924050633";"0.930379746835443";"0.06962025316455696";"0.06329113924050633";"1"
"3928928";"headyhead";"1";"0";"1";"0";"1";"1";"0";"0";"null";"null";"0.0";"1.0";"0.0";"1.0";"1.0";"0.0";"0.0";"1"
"500572";"yopaseopor";"142";"0";"142";"141";"1";"142";"0";"0";"null";"null";"0.0";"1.0";"0.9929577464788732";"0.007042253521126761";"1.0";"0.0";"0.0";"3"
"4350750";"jnk2016";"87";"49";"38";"86";"1";"33";"54";"35";"null";"null";"0.5632183908045977";"0.4367816091954023";"0.9885057471264368";"0.011494252873563218";"0.3793103448275862";"0.6206896551724138";"0.40229885057471265";"2"
"4338460";"Irameshmaharjan";"5";"1";"4";"4";"1";"5";"0";"0";"null";"null";"0.2";"0.8";"0.8";"0.2";"1.0";"0.0";"0.0";"3"
"2872136";"Spgurung";"2";"0";"2";"1";"1";"2";"0";"0";"null";"null";"0.0";"1.0";"0.5";"0.5";"1.0";"0.0";"0.0";"1"
"4231971";"Madan Subedi";"2";"0";"2";"0";"2";"1";"1";"0";"null";"null";"0.0";"1.0";"0.0";"1.0";"0.5";"0.5";"0.0";"1"
"2310983";"Manoj Mahato";"1";"0";"1";"0";"1";"1";"0";"0";"null";"null";"0.0";"1.0";"0.0";"1.0";"1.0";"0.0";"0.0";"1"
"3605330";"nirmalburlakoti";"8";"7";"1";"0";"8";"8";"0";"0";"null";"null";"0.875";"0.125";"0.0";"1.0";"1.0";"0.0";"0.0";"2"
"3400533";"Vijay Chandra Khatiwoda";"1";"0";"1";"0";"1";"1";"0";"0";"null";"null";"0.0";"1.0";"0.0";"1.0";"1.0";"0.0";"0.0";"1"
"2880332";"mphemming";"534";"0";"534";"533";"1";"533";"1";"0";"null";"null";"0.0";"1.0";"0.99812734082397";"0.0018726591760299626";"0.99812734082397";"0.0018726591760299626";"0.0";"10"
"2872129";"kwadada";"82";"0";"82";"21";"61";"27";"55";"4";"null";"null";"0.0";"1.0";"0.25609756097560976";"0.7439024390243902";"0.32926829268292684";"0.6707317073170732";"0.04878048780487805";"15"
"4911933";"Indivar Thapa";"3";"2";"1";"2";"1";"3";"0";"0";"null";"null";"0.6666666666666666";"0.3333333333333333";"0.6666666666666666";"0.3333333333333333";"1.0";"0.0";"0.0";"1"
"1143659";"Tefexus";"19";"0";"19";"18";"1";"12";"7";"0";"null";"null";"0.0";"1.0";"0.9473684210526315";"0.05263157894736842";"0.631578947368421";"0.3684210526315789";"0.0";"1"
"1258351";"Bhagawat Urban Planner";"104";"66";"38";"103";"1";"34";"70";"8";"null";"null";"0.6346153846153846";"0.36538461538461536";"0.9903846153846154";"0.009615384615384616";"0.3269230769230769";"0.6730769230769231";"0.07692307692307693";"11"
"2511706";"calfarome";"152";"60";"92";"151";"1";"102";"50";"25";"null";"null";"0.39473684210526316";"0.6052631578947368";"0.993421052631579";"0.006578947368421052";"0.6710526315789473";"0.32894736842105265";"0.16447368421052633";"29"
"2696020";"tompkh";"66";"65";"1";"65";"1";"29";"37";"12";"null";"null";"0.9848484848484849";"0.015151515151515152";"0.9848484848484849";"0.015151515151515152";"0.4393939393939394";"0.5606060606060606";"0.18181818181818182";"7"
"3011411";"prajwol";"8";"0";"8";"7";"1";"2";"6";"1";"null";"null";"0.0";"1.0";"0.875";"0.125";"0.25";"0.75";"0.125";"1"
"2872148";"mvalpeteris";"34";"0";"34";"33";"1";"34";"0";"0";"null";"null";"0.0";"1.0";"0.9705882352941176";"0.029411764705882353";"1.0";"0.0";"0.0";"3"
"2880340";"LMOC";"44";"0";"44";"43";"1";"0";"44";"12";"null";"null";"0.0";"1.0";"0.9772727272727273";"0.022727272727272728";"0.0";"1.0";"0.2727272727272727";"1"
"4555712";"Roadhouse Restaurant";"1";"0";"1";"0";"1";"1";"0";"0";"null";"null";"0.0";"1.0";"0.0";"1.0";"1.0";"0.0";"0.0";"1"
"2225066";"perry2201";"46";"13";"33";"45";"1";"1";"45";"43";"null";"null";"0.2826086956521739";"0.717391304347826";"0.9782608695652174";"0.021739130434782608";"0.021739130434782608";"0.9782608695652174";"0.9347826086956522";"11"
"4604877";"Deepsy";"10";"9";"1";"7";"3";"8";"2";"0";"null";"null";"0.9";"0.1";"0.7";"0.3";"0.8";"0.2";"0.0";"9"
"181135";"Manu1400";"1";"0";"1";"0";"1";"0";"1";"0";"null";"null";"0.0";"1.0";"0.0";"1.0";"0.0";"1.0";"0.0";"1"
"2880421";"JGSTONE";"54";"0";"54";"53";"1";"52";"2";"1";"null";"null";"0.0";"1.0";"0.9814814814814815";"0.018518518518518517";"0.9629629629629629";"0.037037037037037035";"0.018518518518518517";"12"
"3060641";"Pawan Dhungana";"1";"0";"1";"0";"1";"1";"0";"0";"null";"null";"0.0";"1.0";"0.0";"1.0";"1.0";"0.0";"0.0";"1"
"2114480";"efemm";"2651";"2650";"1";"2650";"1";"2635";"16";"0";"null";"null";"0.999622783855149";"3.772161448509996E-4";"0.999622783855149";"3.772161448509996E-4";"0.993964541682384";"0.006035458317615994";"0.0";"10"
"672666";"jk24";"730";"0";"730";"729";"1";"727";"3";"0";"null";"null";"0.0";"1.0";"0.9986301369863013";"0.0013698630136986301";"0.9958904109589041";"0.00410958904109589";"0.0";"5"
"13203";"bahnpirat";"270";"161";"109";"241";"29";"144";"126";"10";"null";"null";"0.5962962962962963";"0.40370370370370373";"0.8925925925925926";"0.10740740740740741";"0.5333333333333333";"0.4666666666666667";"0.037037037037037035";"19"
"2864063";"katefromformosa";"85";"0";"85";"84";"1";"78";"7";"0";"null";"null";"0.0";"1.0";"0.9882352941176471";"0.011764705882352941";"0.9176470588235294";"0.08235294117647059";"0.0";"4"
"2900917";"spradh";"16";"0";"16";"15";"1";"13";"3";"1";"null";"null";"0.0";"1.0";"0.9375";"0.0625";"0.8125";"0.1875";"0.0625";"1"
"1196943";"yogimapper";"1579";"1389";"190";"865";"714";"1275";"304";"95";"null";"null";"0.8796706776440786";"0.12032932235592148";"0.5478150728309057";"0.45218492716909436";"0.8074730842305257";"0.19252691576947434";"0.06016466117796074";"441"
"455576";"ngt";"676";"410";"266";"616";"60";"646";"30";"19";"null";"null";"0.606508875739645";"0.39349112426035504";"0.9112426035502958";"0.08875739644970414";"0.9556213017751479";"0.04437869822485207";"0.028106508875739646";"8"
"2868149";"moriken_AGU";"4";"3";"1";"3";"1";"4";"0";"0";"null";"null";"0.75";"0.25";"0.75";"0.25";"1.0";"0.0";"0.0";"1"
"2868106";"JDG78";"106";"0";"106";"105";"1";"106";"0";"0";"null";"null";"0.0";"1.0";"0.9905660377358491";"0.009433962264150943";"1.0";"0.0";"0.0";"1"
"3470227";"Votez";"1";"0";"1";"0";"1";"1";"0";"0";"null";"null";"0.0";"1.0";"0.0";"1.0";"1.0";"0.0";"0.0";"1"
"2872195";"jac111";"43";"0";"43";"42";"1";"42";"1";"0";"null";"null";"0.0";"1.0";"0.9767441860465116";"0.023255813953488372";"0.9767441860465116";"0.023255813953488372";"0.0";"3"
"2909060";"neeva";"109";"0";"109";"108";"1";"44";"65";"34";"null";"null";"0.0";"1.0";"0.9908256880733946";"0.009174311926605505";"0.4036697247706422";"0.5963302752293578";"0.3119266055045872";"2"
"693154";"Władysław Komorek";"2";"0";"2";"1";"1";"0";"2";"1";"null";"null";"0.0";"1.0";"0.5";"0.5";"0.0";"1.0";"0.5";"1"
"1545145";"SanjeevNepal";"14";"13";"1";"13";"1";"11";"3";"0";"null";"null";"0.9285714285714286";"0.07142857142857142";"0.9285714285714286";"0.07142857142857142";"0.7857142857142857";"0.21428571428571427";"0.0";"3"
"2868124";"Faleh Aldham";"7";"0";"7";"6";"1";"7";"0";"0";"null";"null";"0.0";"1.0";"0.8571428571428571";"0.14285714285714285";"1.0";"0.0";"0.0";"1"
"4633598";"MYSTERIOUS99";"1";"0";"1";"0";"1";"0";"1";"0";"null";"null";"0.0";"1.0";"0.0";"1.0";"0.0";"1.0";"0.0";"1"
"3552136";"rikeshrajbangshi";"4";"3";"1";"3";"1";"4";"0";"0";"null";"null";"0.75";"0.25";"0.75";"0.25";"1.0";"0.0";"0.0";"1"
"4264959";"Prajwal Prasain";"1";"0";"1";"0";"1";"1";"0";"0";"null";"null";"0.0";"1.0";"0.0";"1.0";"1.0";"0.0";"0.0";"1"
"4494331";"Smanta";"3";"0";"3";"2";"1";"3";"0";"0";"null";"null";"0.0";"1.0";"0.6666666666666666";"0.3333333333333333";"1.0";"0.0";"0.0";"3"
"2880495";"acameron";"4";"0";"4";"3";"1";"4";"0";"0";"null";"null";"0.0";"1.0";"0.75";"0.25";"1.0";"0.0";"0.0";"1"
"1197015";"benoitberlin";"148";"147";"1";"147";"1";"148";"0";"0";"null";"null";"0.9932432432432432";"0.006756756756756757";"0.9932432432432432";"0.006756756756756757";"1.0";"0.0";"0.0";"4"
"3359733";"Jimmi Sherpa";"3";"0";"3";"2";"1";"3";"0";"0";"null";"null";"0.0";"1.0";"0.6666666666666666";"0.3333333333333333";"1.0";"0.0";"0.0";"1"
"4539273";"Mali Jal";"4";"0";"4";"3";"1";"2";"2";"0";"null";"null";"0.0";"1.0";"0.75";"0.25";"0.5";"0.5";"0.0";"4"
"2872295";"Prajiv Bhattarai";"5";"0";"5";"4";"1";"0";"5";"1";"null";"null";"0.0";"1.0";"0.8";"0.2";"0.0";"1.0";"0.2";"3"
"2880487";"rootsy";"97";"0";"97";"96";"1";"97";"0";"0";"null";"null";"0.0";"1.0";"0.9896907216494846";"0.010309278350515464";"1.0";"0.0";"0.0";"1"
"2098157";"SANA Ibrahim";"478";"0";"478";"0";"478";"369";"109";"23";"null";"null";"0.0";"1.0";"0.0";"1.0";"0.7719665271966527";"0.2280334728033473";"0.04811715481171548";"9"
"2339822";"Clara AgborTabi";"3";"0";"3";"2";"1";"3";"0";"0";"null";"null";"0.0";"1.0";"0.6666666666666666";"0.3333333333333333";"1.0";"0.0";"0.0";"1"
"1967054";"Disaster Manager";"1";"0";"1";"0";"1";"1";"0";"0";"null";"null";"0.0";"1.0";"0.0";"1.0";"1.0";"0.0";"0.0";"1"
"533465";"GerdP";"1";"0";"1";"0";"1";"1";"0";"0";"null";"null";"0.0";"1.0";"0.0";"1.0";"1.0";"0.0";"0.0";"1"
"177110";"Sadik";"19";"18";"1";"18";"1";"10";"9";"4";"null";"null";"0.9473684210526315";"0.05263157894736842";"0.9473684210526315";"0.05263157894736842";"0.5263157894736842";"0.47368421052631576";"0.21052631578947367";"1"
"189397";"siaud xavier";"104";"103";"1";"103";"1";"82";"22";"6";"null";"null";"0.9903846153846154";"0.009615384615384616";"0.9903846153846154";"0.009615384615384616";"0.7884615384615384";"0.21153846153846154";"0.057692307692307696";"3"
"62423";"maction";"543";"542";"1";"542";"1";"183";"360";"29";"null";"null";"0.998158379373849";"0.001841620626151013";"0.998158379373849";"0.001841620626151013";"0.3370165745856354";"0.6629834254143646";"0.053406998158379376";"2"
"2872316";"osm_hamp";"1";"0";"1";"0";"1";"1";"0";"0";"null";"null";"0.0";"1.0";"0.0";"1.0";"1.0";"0.0";"0.0";"1"
"2143223";"Sawdust Maker";"141";"7";"134";"140";"1";"141";"0";"0";"null";"null";"0.04964539007092199";"0.950354609929078";"0.9929078014184397";"0.0070921985815602835";"1.0";"0.0";"0.0";"6"
"4932498";"Shiv Shankar Thakur";"1";"0";"1";"0";"1";"1";"0";"0";"null";"null";"0.0";"1.0";"0.0";"1.0";"1.0";"0.0";"0.0";"1"
"33757";"Minh Nguyen";"1";"0";"1";"0";"1";"0";"1";"0";"null";"null";"0.0";"1.0";"0.0";"1.0";"0.0";"1.0";"0.0";"1"
"4891563";"Sam509";"1";"0";"1";"0";"1";"1";"0";"0";"null";"null";"0.0";"1.0";"0.0";"1.0";"1.0";"0.0";"0.0";"1"
"4801440";"Rojal Shrestha";"1";"0";"1";"0";"1";"1";"0";"0";"null";"null";"0.0";"1.0";"0.0";"1.0";"1.0";"0.0";"0.0";"1"
"2872263";"timthomas";"27";"0";"27";"26";"1";"27";"0";"0";"null";"null";"0.0";"1.0";"0.9629629629629629";"0.037037037037037035";"1.0";"0.0";"0.0";"1"
"246767";"yerg";"1";"0";"1";"0";"1";"1";"0";"0";"null";"null";"0.0";"1.0";"0.0";"1.0";"1.0";"0.0";"0.0";"1"
"2892767";"prithu";"61";"0";"61";"60";"1";"41";"20";"4";"null";"null";"0.0";"1.0";"0.9836065573770492";"0.01639344262295082";"0.6721311475409836";"0.32786885245901637";"0.06557377049180328";"11"
"78839";"xfairy";"4";"3";"1";"3";"1";"4";"0";"0";"null";"null";"0.75";"0.25";"0.75";"0.25";"1.0";"0.0";"0.0";"1"
"1864682";"ualios";"1";"0";"1";"0";"1";"0";"1";"0";"null";"null";"0.0";"1.0";"0.0";"1.0";"0.0";"1.0";"0.0";"1"
"2864092";"rq2";"217";"212";"5";"216";"1";"217";"0";"0";"null";"null";"0.9769585253456221";"0.02304147465437788";"0.9953917050691244";"0.004608294930875576";"1.0";"0.0";"0.0";"3"
"74742";"Rajan M B";"7";"0";"7";"6";"1";"0";"7";"0";"null";"null";"0.0";"1.0";"0.8571428571428571";"0.14285714285714285";"0.0";"1.0";"0.0";"1"
"74746";"vogelfreier";"924";"922";"2";"923";"1";"542";"382";"14";"null";"null";"0.9978354978354979";"0.0021645021645021645";"0.9989177489177489";"0.0010822510822510823";"0.5865800865800865";"0.4134199134199134";"0.015151515151515152";"6"
"3838918";"am45ar";"9";"5";"4";"6";"3";"9";"0";"0";"null";"null";"0.5555555555555556";"0.4444444444444444";"0.6666666666666666";"0.3333333333333333";"1.0";"0.0";"0.0";"4"
"2102237";"nadrosch";"4";"3";"1";"3";"1";"1";"3";"3";"null";"null";"0.75";"0.25";"0.75";"0.25";"0.25";"0.75";"0.75";"2"
"574454";"jamacho";"2494";"599";"1895";"2229";"265";"928";"1566";"1036";"null";"null";"0.24017642341619888";"0.7598235765838012";"0.8937449879711307";"0.10625501202886929";"0.37209302325581395";"0.627906976744186";"0.4153969526864475";"172"
"4854850";"Rajiv Shrhestha";"1";"0";"1";"0";"1";"1";"0";"0";"null";"null";"0.0";"1.0";"0.0";"1.0";"1.0";"0.0";"0.0";"1"
"4310091";"prakashrestha";"1";"0";"1";"0";"1";"1";"0";"0";"null";"null";"0.0";"1.0";"0.0";"1.0";"1.0";"0.0";"0.0";"1"
"4600909";"Luza Sayami";"6";"0";"6";"0";"6";"5";"1";"0";"null";"null";"0.0";"1.0";"0.0";"1.0";"0.8333333333333334";"0.16666666666666666";"0.0";"1"
"1451032";"mjolnirr";"37";"36";"1";"36";"1";"12";"25";"5";"null";"null";"0.972972972972973";"0.02702702702702703";"0.972972972972973";"0.02702702702702703";"0.32432432432432434";"0.6756756756756757";"0.13513513513513514";"1"
"3789870";"RamkrishnaDangal";"3";"2";"1";"2";"1";"3";"0";"0";"null";"null";"0.6666666666666666";"0.3333333333333333";"0.6666666666666666";"0.3333333333333333";"1.0";"0.0";"0.0";"3"
"2008073";"rupesh07";"5";"0";"5";"0";"5";"4";"1";"0";"null";"null";"0.0";"1.0";"0.0";"1.0";"0.8";"0.2";"0.0";"3"
"1048";"dongpo";"1017";"1016";"1";"0";"1017";"1006";"11";"2";"null";"null";"0.9990167158308751";"9.832841691248771E-4";"0.0";"1.0";"0.9891838741396264";"0.010816125860373648";"0.0019665683382497543";"1"
"1758210";"awReimer";"395";"137";"258";"394";"1";"395";"0";"0";"null";"null";"0.3468354430379747";"0.6531645569620254";"0.9974683544303797";"0.002531645569620253";"1.0";"0.0";"0.0";"4"
"3859483";"Raam K Maharjan";"1";"0";"1";"0";"1";"1";"0";"0";"null";"null";"0.0";"1.0";"0.0";"1.0";"1.0";"0.0";"0.0";"1"
"2872329";"helpnepal";"14";"0";"14";"13";"1";"14";"0";"0";"null";"null";"0.0";"1.0";"0.9285714285714286";"0.07142857142857142";"1.0";"0.0";"0.0";"3"
"2909198";"Ozark Cave Mapper";"37";"0";"37";"36";"1";"37";"0";"0";"null";"null";"0.0";"1.0";"0.972972972972973";"0.02702702702702703";"1.0";"0.0";"0.0";"8"
"3130370";"Sudhir Raj";"3";"1";"2";"2";"1";"3";"0";"0";"null";"null";"0.3333333333333333";"0.6666666666666666";"0.6666666666666666";"0.3333333333333333";"1.0";"0.0";"0.0";"3"
"2872336";"KamalThapa";"5";"0";"5";"4";"1";"4";"1";"0";"null";"null";"0.0";"1.0";"0.8";"0.2";"0.8";"0.2";"0.0";"2"
"2483224";"Ajit poudel";"4";"3";"1";"0";"4";"3";"1";"0";"null";"null";"0.75";"0.25";"0.0";"1.0";"0.75";"0.25";"0.0";"4"
"2851860";"Chingping Yu";"251";"0";"251";"250";"1";"251";"0";"0";"null";"null";"0.0";"1.0";"0.9960159362549801";"0.00398406374501992";"1.0";"0.0";"0.0";"5"
"3101805";"Chatur Shakya";"109";"92";"17";"64";"45";"93";"16";"3";"null";"null";"0.8440366972477065";"0.1559633027522936";"0.5871559633027523";"0.41284403669724773";"0.8532110091743119";"0.14678899082568808";"0.027522935779816515";"12"
"1659997";"Général gamkisi";"2616";"1298";"1318";"0";"2616";"2551";"65";"4";"null";"null";"0.49617737003058104";"0.503822629969419";"0.0";"1.0";"0.9751529051987767";"0.02484709480122324";"0.0015290519877675841";"1"
"2872430";"jebik";"2";"0";"2";"1";"1";"2";"0";"0";"null";"null";"0.0";"1.0";"0.5";"0.5";"1.0";"0.0";"0.0";"1"
"2892907";"Andrew in Chicago";"192";"191";"1";"191";"1";"185";"7";"3";"null";"null";"0.9947916666666666";"0.005208333333333333";"0.9947916666666666";"0.005208333333333333";"0.9635416666666666";"0.036458333333333336";"0.015625";"1"
"2323563";"SpikyclowN";"7";"0";"7";"6";"1";"1";"6";"6";"null";"null";"0.0";"1.0";"0.8571428571428571";"0.14285714285714285";"0.14285714285714285";"0.8571428571428571";"0.8571428571428571";"1"
"2323562";"Akash Mainali";"59";"57";"2";"0";"59";"52";"7";"1";"null";"null";"0.9661016949152542";"0.03389830508474576";"0.0";"1.0";"0.8813559322033898";"0.11864406779661017";"0.01694915254237288";"3"
"2876512";"Aidan Magee";"303";"283";"20";"19";"284";"268";"35";"26";"null";"null";"0.933993399339934";"0.066006600660066";"0.0627062706270627";"0.9372937293729373";"0.8844884488448845";"0.11551155115511551";"0.0858085808580858";"8"
"758853";"Prakash Neupane";"5";"4";"1";"4";"1";"1";"4";"0";"null";"null";"0.8";"0.2";"0.8";"0.2";"0.2";"0.8";"0.0";"2"
"2323565";"Abinash09";"443";"51";"392";"391";"52";"411";"32";"1";"null";"null";"0.11512415349887133";"0.8848758465011287";"0.8826185101580135";"0.11738148984198646";"0.927765237020316";"0.07223476297968397";"0.002257336343115124";"23"
"2323564";"darshandip";"98";"55";"43";"60";"38";"64";"34";"31";"null";"null";"0.5612244897959183";"0.4387755102040816";"0.6122448979591837";"0.3877551020408163";"0.6530612244897959";"0.3469387755102041";"0.3163265306122449";"12"
"4752391";"anjay khadka";"1";"0";"1";"0";"1";"1";"0";"0";"null";"null";"0.0";"1.0";"0.0";"1.0";"1.0";"0.0";"0.0";"1"
"4539413";"Shuvam Pyakurel";"1";"0";"1";"0";"1";"0";"1";"0";"null";"null";"0.0";"1.0";"0.0";"1.0";"0.0";"1.0";"0.0";"1"
"2323575";"BishnuDhungana";"54";"39";"15";"18";"36";"44";"10";"7";"null";"null";"0.7222222222222222";"0.2777777777777778";"0.3333333333333333";"0.6666666666666666";"0.8148148148148148";"0.18518518518518517";"0.12962962962962962";"5"
"4813852";"Aabhash G";"48";"47";"1";"47";"1";"29";"19";"6";"null";"null";"0.9791666666666666";"0.020833333333333332";"0.9791666666666666";"0.020833333333333332";"0.6041666666666666";"0.3958333333333333";"0.125";"2"
"2909305";"JWGEO";"12";"0";"12";"11";"1";"10";"2";"2";"null";"null";"0.0";"1.0";"0.9166666666666666";"0.08333333333333333";"0.8333333333333334";"0.16666666666666666";"0.16666666666666666";"2"
"2843773";"nishioka yohsuke";"1078";"107";"971";"1077";"1";"564";"514";"28";"null";"null";"0.09925788497217068";"0.9007421150278293";"0.9990723562152134";"9.276437847866419E-4";"0.5231910946196661";"0.47680890538033394";"0.025974025974025976";"12"
"4981786";"ongoing";"3";"0";"3";"1";"2";"1";"2";"0";"null";"null";"0.0";"1.0";"0.3333333333333333";"0.6666666666666666";"0.3333333333333333";"0.6666666666666666";"0.0";"3"
"2323578";"Apex_Dipak";"18";"0";"18";"17";"1";"7";"11";"3";"null";"null";"0.0";"1.0";"0.9444444444444444";"0.05555555555555555";"0.3888888888888889";"0.6111111111111112";"0.16666666666666666";"1"
"2876530";"AlyneG";"2";"0";"2";"1";"1";"2";"0";"0";"null";"null";"0.0";"1.0";"0.5";"0.5";"1.0";"0.0";"0.0";"1"
"2323577";"bij";"38";"0";"38";"37";"1";"23";"15";"15";"null";"null";"0.0";"1.0";"0.9736842105263158";"0.02631578947368421";"0.6052631578947368";"0.39473684210526316";"0.39473684210526316";"4"
"3507307";"Tenzings";"13";"12";"1";"12";"1";"3";"10";"2";"null";"null";"0.9230769230769231";"0.07692307692307693";"0.9230769230769231";"0.07692307692307693";"0.23076923076923078";"0.7692307692307693";"0.15384615384615385";"2"
"4912149";"Swarup stha";"1";"0";"1";"0";"1";"1";"0";"0";"null";"null";"0.0";"1.0";"0.0";"1.0";"1.0";"0.0";"0.0";"1"
"2479174";"Raznewa";"7";"0";"7";"0";"7";"6";"1";"1";"null";"null";"0.0";"1.0";"0.0";"1.0";"0.8571428571428571";"0.14285714285714285";"0.14285714285714285";"1"
"1799294";"Boss Dév";"94";"40";"54";"0";"94";"78";"16";"5";"null";"null";"0.425531914893617";"0.574468085106383";"0.0";"1.0";"0.8297872340425532";"0.1702127659574468";"0.05319148936170213";"4"
"2876493";"Praswish";"85";"0";"85";"84";"1";"61";"24";"18";"null";"null";"0.0";"1.0";"0.9882352941176471";"0.011764705882352941";"0.7176470588235294";"0.2823529411764706";"0.21176470588235294";"1"
"4654112";"prakash bikram bhat";"1";"0";"1";"0";"1";"1";"0";"0";"null";"null";"0.0";"1.0";"0.0";"1.0";"1.0";"0.0";"0.0";"1"
"4785184";"Manoj Aathpahariya";"5";"1";"4";"4";"1";"4";"1";"0";"null";"null";"0.2";"0.8";"0.8";"0.2";"0.8";"0.2";"0.0";"4"
"2892865";"Ricardo(nemo)";"76";"0";"76";"75";"1";"74";"2";"0";"null";"null";"0.0";"1.0";"0.9868421052631579";"0.013157894736842105";"0.9736842105263158";"0.02631578947368421";"0.0";"1"
"2778180";"Jaefoo";"19";"0";"19";"18";"1";"19";"0";"0";"null";"null";"0.0";"1.0";"0.9473684210526315";"0.05263157894736842";"1.0";"0.0";"0.0";"1"
"1778799";"SomeoneElse_Revert";"1";"0";"1";"0";"1";"0";"1";"0";"null";"null";"0.0";"1.0";"0.0";"1.0";"0.0";"1.0";"0.0";"1"
"2880605";"VanessaG";"137";"0";"137";"136";"1";"137";"0";"0";"null";"null";"0.0";"1.0";"0.9927007299270073";"0.0072992700729927005";"1.0";"0.0";"0.0";"1"
"1909861";"Abhishek Dutta";"1";"0";"1";"0";"1";"1";"0";"0";"null";"null";"0.0";"1.0";"0.0";"1.0";"1.0";"0.0";"0.0";"1"
"2880593";"Lindsaym93";"194";"0";"194";"193";"1";"136";"58";"4";"null";"null";"0.0";"1.0";"0.9948453608247423";"0.005154639175257732";"0.7010309278350515";"0.29896907216494845";"0.020618556701030927";"3"
"758896";"suraj bhusal";"10";"0";"10";"9";"1";"5";"5";"1";"null";"null";"0.0";"1.0";"0.9";"0.1";"0.5";"0.5";"0.1";"2"
"4326462";"tnagorra";"415";"121";"294";"89";"326";"113";"302";"78";"null";"null";"0.29156626506024097";"0.708433734939759";"0.21445783132530122";"0.7855421686746988";"0.27228915662650605";"0.727710843373494";"0.18795180722891566";"11"
"2872404";"Pureza";"13";"0";"13";"12";"1";"13";"0";"0";"null";"null";"0.0";"1.0";"0.9230769230769231";"0.07692307692307693";"1.0";"0.0";"0.0";"4"
"464007";"Ratterkresch";"114";"0";"114";"113";"1";"114";"0";"0";"null";"null";"0.0";"1.0";"0.9912280701754386";"0.008771929824561403";"1.0";"0.0";"0.0";"2"
"4941001";"Namxal khusu";"3";"1";"2";"2";"1";"3";"0";"0";"null";"null";"0.3333333333333333";"0.6666666666666666";"0.6666666666666666";"0.3333333333333333";"1.0";"0.0";"0.0";"3"
"2876590";"Pascaline Wallemacq";"1";"0";"1";"0";"1";"0";"1";"0";"null";"null";"0.0";"1.0";"0.0";"1.0";"0.0";"1.0";"0.0";"1"
"2876578";"JMed";"249";"0";"249";"248";"1";"248";"1";"0";"null";"null";"0.0";"1.0";"0.9959839357429718";"0.004016064257028112";"0.9959839357429718";"0.004016064257028112";"0.0";"4"
"5043397";"Roshan_thapa46";"1";"0";"1";"0";"1";"1";"0";"0";"null";"null";"0.0";"1.0";"0.0";"1.0";"1.0";"0.0";"0.0";"1"
"4842690";"N'raaz Teewahry";"1";"0";"1";"0";"1";"1";"0";"0";"null";"null";"0.0";"1.0";"0.0";"1.0";"1.0";"0.0";"0.0";"1"
"926851";"ktmdude";"136";"135";"1";"135";"1";"38";"98";"59";"null";"null";"0.9926470588235294";"0.007352941176470588";"0.9926470588235294";"0.007352941176470588";"0.27941176470588236";"0.7205882352941176";"0.4338235294117647";"5"
"4248784";"Soñador Soñadora";"1";"0";"1";"0";"1";"1";"0";"0";"null";"null";"0.0";"1.0";"0.0";"1.0";"1.0";"0.0";"0.0";"1"
"611481";"momobites";"47";"0";"47";"0";"47";"39";"8";"0";"null";"null";"0.0";"1.0";"0.0";"1.0";"0.8297872340425532";"0.1702127659574468";"0.0";"10"
"2749626";"H0ffman";"17";"16";"1";"16";"1";"16";"1";"0";"null";"null";"0.9411764705882353";"0.058823529411764705";"0.9411764705882353";"0.058823529411764705";"0.9411764705882353";"0.058823529411764705";"0.0";"3"
"402585";"Kioska Journo";"618";"617";"1";"617";"1";"475";"143";"6";"null";"null";"0.9983818770226537";"0.0016181229773462784";"0.9983818770226537";"0.0016181229773462784";"0.7686084142394822";"0.2313915857605178";"0.009708737864077669";"1"
"62623";"thirteen";"386";"0";"386";"385";"1";"386";"0";"0";"null";"null";"0.0";"1.0";"0.9974093264248705";"0.0025906735751295338";"1.0";"0.0";"0.0";"4"
"46239";"MatthieuMartin";"49";"48";"1";"0";"49";"49";"0";"0";"null";"null";"0.9795918367346939";"0.02040816326530612";"0.0";"1.0";"1.0";"0.0";"0.0";"2"
"1238195";"Niroj Panta";"4291";"2082";"2209";"3915";"376";"2760";"1531";"705";"null";"null";"0.4852015847121883";"0.5147984152878117";"0.9123747378233512";"0.0876252621766488";"0.6432067117222092";"0.3567932882777907";"0.1642973665812165";"22"
"2323588";"abishek shrestha";"71";"41";"30";"29";"42";"63";"8";"5";"null";"null";"0.5774647887323944";"0.4225352112676056";"0.4084507042253521";"0.5915492957746479";"0.8873239436619719";"0.11267605633802817";"0.07042253521126761";"15"
"2966661";"Subham156";"11";"10";"1";"10";"1";"2";"9";"0";"null";"null";"0.9090909090909091";"0.09090909090909091";"0.9090909090909091";"0.09090909090909091";"0.18181818181818182";"0.8181818181818182";"0.0";"3"
"4605164";"Ishwary Kharel";"1";"0";"1";"0";"1";"1";"0";"0";"null";"null";"0.0";"1.0";"0.0";"1.0";"1.0";"0.0";"0.0";"1"
"4797667";"Gajendra joshi";"1";"0";"1";"0";"1";"1";"0";"0";"null";"null";"0.0";"1.0";"0.0";"1.0";"1.0";"0.0";"0.0";"1"
"2323592";"atish";"3";"0";"3";"2";"1";"2";"1";"0";"null";"null";"0.0";"1.0";"0.6666666666666666";"0.3333333333333333";"0.6666666666666666";"0.3333333333333333";"0.0";"3"
"4981991";"Suyog Raj Dhamala";"10";"9";"1";"9";"1";"10";"0";"0";"null";"null";"0.9";"0.1";"0.9";"0.1";"1.0";"0.0";"0.0";"1"
"1782960";"emacsen_dwg";"18";"0";"18";"17";"1";"0";"18";"18";"null";"null";"0.0";"1.0";"0.9444444444444444";"0.05555555555555555";"0.0";"1.0";"1.0";"2"
"2892928";"TJohnson15";"399";"0";"399";"398";"1";"399";"0";"0";"null";"null";"0.0";"1.0";"0.9974937343358395";"0.002506265664160401";"1.0";"0.0";"0.0";"4"
"3196032";"manoj bajracharya";"9";"8";"1";"0";"9";"9";"0";"0";"null";"null";"0.8888888888888888";"0.1111111111111111";"0.0";"1.0";"1.0";"0.0";"0.0";"1"
"128186";"malcolmh";"1";"0";"1";"0";"1";"0";"1";"0";"null";"null";"0.0";"1.0";"0.0";"1.0";"0.0";"1.0";"0.0";"1"
"4777098";"Sundar Dangol";"1";"0";"1";"0";"1";"1";"0";"0";"null";"null";"0.0";"1.0";"0.0";"1.0";"1.0";"0.0";"0.0";"1"
"4863113";"Rupakpaneru";"1";"0";"1";"0";"1";"1";"0";"0";"null";"null";"0.0";"1.0";"0.0";"1.0";"1.0";"0.0";"0.0";"1"
"2860271";"Carline";"462";"0";"462";"435";"27";"462";"0";"0";"null";"null";"0.0";"1.0";"0.9415584415584416";"0.05844155844155844";"1.0";"0.0";"0.0";"53"
"1995994";"Aimé BOUKPESSI";"10";"0";"10";"0";"10";"0";"10";"0";"null";"null";"0.0";"1.0";"0.0";"1.0";"0.0";"1.0";"0.0";"1"
"3863806";"Manishbimali";"6";"4";"2";"5";"1";"6";"0";"0";"null";"null";"0.6666666666666666";"0.3333333333333333";"0.8333333333333334";"0.16666666666666666";"1.0";"0.0";"0.0";"5"
"4256901";"Sandesh Man Maharjan";"5";"2";"3";"2";"3";"1";"4";"0";"null";"null";"0.4";"0.6";"0.4";"0.6";"0.2";"0.8";"0.0";"5"
"4494478";"Sonik Shrestha";"2";"1";"1";"1";"1";"2";"0";"0";"null";"null";"0.5";"0.5";"0.5";"0.5";"1.0";"0.0";"0.0";"2"
"38090";"ezekielf";"6";"0";"6";"0";"6";"1";"5";"0";"null";"null";"0.0";"1.0";"0.0";"1.0";"0.16666666666666666";"0.8333333333333334";"0.0";"1"
"2913504";"Atikur Rahman atik";"8";"7";"1";"7";"1";"8";"0";"0";"null";"null";"0.875";"0.125";"0.875";"0.125";"1.0";"0.0";"0.0";"1"
"3769588";"TheLifeStory";"40";"15";"25";"39";"1";"27";"13";"8";"null";"null";"0.375";"0.625";"0.975";"0.025";"0.675";"0.325";"0.2";"16"
"4207759";"Dental Art Clinic";"1";"0";"1";"0";"1";"1";"0";"0";"null";"null";"0.0";"1.0";"0.0";"1.0";"1.0";"0.0";"0.0";"1"
"1062080";"amitangshu";"18";"17";"1";"0";"18";"0";"18";"4";"null";"null";"0.9444444444444444";"0.05555555555555555";"0.0";"1.0";"0.0";"1.0";"0.2222222222222222";"3"
"226516";"PierZen";"47";"16";"31";"30";"17";"36";"11";"3";"null";"null";"0.3404255319148936";"0.6595744680851063";"0.6382978723404256";"0.3617021276595745";"0.7659574468085106";"0.23404255319148937";"0.06382978723404255";"3"
"4736148";"Victor Pereverzev";"2";"0";"2";"1";"1";"2";"0";"0";"null";"null";"0.0";"1.0";"0.5";"0.5";"1.0";"0.0";"0.0";"2"
"2102526";"㌔㍉ｺﾝ";"15";"0";"15";"14";"1";"4";"11";"7";"null";"null";"0.0";"1.0";"0.9333333333333333";"0.06666666666666667";"0.26666666666666666";"0.7333333333333333";"0.4666666666666667";"1"
"2884850";"Greta Ferloni";"610";"127";"483";"127";"483";"584";"26";"8";"null";"null";"0.2081967213114754";"0.7918032786885246";"0.2081967213114754";"0.7918032786885246";"0.9573770491803278";"0.04262295081967213";"0.013114754098360656";"3"
"1942781";"yellowsoar";"258";"257";"1";"257";"1";"149";"109";"10";"null";"null";"0.9961240310077519";"0.003875968992248062";"0.9961240310077519";"0.003875968992248062";"0.5775193798449613";"0.42248062015503873";"0.03875968992248062";"1"
"1041644";"david nhemaphuki";"2866";"2299";"567";"2545";"321";"1628";"1238";"279";"null";"null";"0.8021632937892533";"0.1978367062107467";"0.8879972086531751";"0.11200279134682484";"0.5680390788555478";"0.4319609211444522";"0.09734822051639916";"99"
"4285604";"ankurlama";"1";"0";"1";"0";"1";"0";"1";"0";"null";"null";"0.0";"1.0";"0.0";"1.0";"0.0";"1.0";"0.0";"1"
"2102478";"takatsuka";"582";"569";"13";"244";"338";"459";"123";"24";"null";"null";"0.9776632302405498";"0.022336769759450172";"0.41924398625429554";"0.5807560137457045";"0.788659793814433";"0.211340206185567";"0.041237113402061855";"10"
"2262221";"marcale";"6039";"3911";"2128";"6038";"1";"5420";"619";"31";"null";"null";"0.6476237787713197";"0.35237622122868023";"0.9998344096704752";"1.6559032952475575E-4";"0.8974995860241762";"0.10250041397582381";"0.005133300215267428";"25"
"5359";"user_5359";"9";"7";"2";"7";"2";"1";"8";"1";"null";"null";"0.7777777777777778";"0.2222222222222222";"0.7777777777777778";"0.2222222222222222";"0.1111111111111111";"0.8888888888888888";"0.1111111111111111";"3"
"3032280";"john10235";"1";"0";"1";"0";"1";"1";"0";"0";"null";"null";"0.0";"1.0";"0.0";"1.0";"1.0";"0.0";"0.0";"1"
"2053352";"giannisax";"1";"0";"1";"0";"1";"1";"0";"0";"null";"null";"0.0";"1.0";"0.0";"1.0";"1.0";"0.0";"0.0";"1"
"2860243";"kqian";"307";"0";"307";"0";"307";"305";"2";"2";"null";"null";"0.0";"1.0";"0.0";"1.0";"0.993485342019544";"0.006514657980456026";"0.006514657980456026";"4"
"169211";"Simone Saviolo";"218";"0";"218";"217";"1";"212";"6";"4";"null";"null";"0.0";"1.0";"0.9954128440366973";"0.0045871559633027525";"0.9724770642201835";"0.027522935779816515";"0.01834862385321101";"4"
"2675923";"Dave Milledge";"4";"3";"1";"3";"1";"4";"0";"0";"null";"null";"0.75";"0.25";"0.75";"0.25";"1.0";"0.0";"0.0";"1"
"4875594";"Milan Shrestha";"5";"0";"5";"2";"3";"3";"2";"0";"null";"null";"0.0";"1.0";"0.4";"0.6";"0.6";"0.4";"0.0";"2"
"2876718";"madzie";"69";"0";"69";"68";"1";"41";"28";"28";"null";"null";"0.0";"1.0";"0.9855072463768116";"0.014492753623188406";"0.5942028985507246";"0.4057971014492754";"0.4057971014492754";"3"
"1787154";"AliGazala";"1";"0";"1";"0";"1";"1";"0";"0";"null";"null";"0.0";"1.0";"0.0";"1.0";"1.0";"0.0";"0.0";"1"
"2037013";"sumira";"3";"2";"1";"0";"3";"2";"1";"1";"null";"null";"0.6666666666666666";"0.3333333333333333";"0.0";"1.0";"0.6666666666666666";"0.3333333333333333";"0.3333333333333333";"2"
"1795342";"tapanmahapatra";"1";"0";"1";"0";"1";"0";"1";"1";"null";"null";"0.0";"1.0";"0.0";"1.0";"0.0";"1.0";"1.0";"1"
"1306";"PlaneMad";"165";"31";"134";"153";"12";"15";"150";"109";"null";"null";"0.18787878787878787";"0.8121212121212121";"0.9272727272727272";"0.07272727272727272";"0.09090909090909091";"0.9090909090909091";"0.6606060606060606";"13"
"595221";"matthieun";"35";"0";"35";"34";"1";"17";"18";"10";"null";"null";"0.0";"1.0";"0.9714285714285714";"0.02857142857142857";"0.4857142857142857";"0.5142857142857142";"0.2857142857142857";"1"
"4457817";"Ram kumar Bhandari";"2";"1";"1";"1";"1";"1";"1";"0";"null";"null";"0.5";"0.5";"0.5";"0.5";"0.5";"0.5";"0.0";"2"
"2876725";"bibek_barahi";"5";"0";"5";"4";"1";"2";"3";"1";"null";"null";"0.0";"1.0";"0.8";"0.2";"0.4";"0.6";"0.2";"2"
"5043538";"Sachit123";"1";"0";"1";"0";"1";"1";"0";"0";"null";"null";"0.0";"1.0";"0.0";"1.0";"1.0";"0.0";"0.0";"1"
"4355424";"Gobag";"7";"6";"1";"6";"1";"3";"4";"0";"null";"null";"0.8571428571428571";"0.14285714285714285";"0.8571428571428571";"0.14285714285714285";"0.42857142857142855";"0.5714285714285714";"0.0";"1"
"2868488";"JohannesMaurer";"14";"13";"1";"13";"1";"14";"0";"0";"null";"null";"0.9285714285714286";"0.07142857142857142";"0.9285714285714286";"0.07142857142857142";"1.0";"0.0";"0.0";"1"
"2880782";"ddk2130";"1";"0";"1";"0";"1";"0";"1";"0";"null";"null";"0.0";"1.0";"0.0";"1.0";"0.0";"1.0";"0.0";"1"
"2983173";"pragon977";"144";"19";"125";"143";"1";"79";"65";"40";"null";"null";"0.13194444444444445";"0.8680555555555556";"0.9930555555555556";"0.006944444444444444";"0.5486111111111112";"0.4513888888888889";"0.2777777777777778";"37"
"4097300";"UmEs Manandhar";"12";"4";"8";"10";"2";"11";"1";"0";"null";"null";"0.3333333333333333";"0.6666666666666666";"0.8333333333333334";"0.16666666666666666";"0.9166666666666666";"0.08333333333333333";"0.0";"9"
"2794752";"Ngawa Dream Cafe";"8";"7";"1";"7";"1";"6";"2";"1";"null";"null";"0.875";"0.125";"0.875";"0.125";"0.75";"0.25";"0.125";"2"
"419114";"msujoseph";"277";"276";"1";"276";"1";"238";"39";"1";"null";"null";"0.9963898916967509";"0.0036101083032490976";"0.9963898916967509";"0.0036101083032490976";"0.8592057761732852";"0.1407942238267148";"0.0036101083032490976";"17"
"3114243";"Ashim Manna";"4";"0";"4";"0";"4";"4";"0";"0";"null";"null";"0.0";"1.0";"0.0";"1.0";"1.0";"0.0";"0.0";"1"
"2749700";"BHANUBHAKTA";"671";"491";"180";"583";"88";"457";"214";"102";"null";"null";"0.7317436661698957";"0.26825633383010433";"0.8688524590163934";"0.13114754098360656";"0.6810730253353204";"0.31892697466467956";"0.15201192250372578";"24"
"4855160";"Jacek Rams";"2";"0";"2";"1";"1";"2";"0";"0";"null";"null";"0.0";"1.0";"0.5";"0.5";"1.0";"0.0";"0.0";"2"
"1201445";"Ban Medo";"122";"3";"119";"91";"31";"100";"22";"1";"null";"null";"0.02459016393442623";"0.9754098360655737";"0.7459016393442623";"0.2540983606557377";"0.819672131147541";"0.18032786885245902";"0.00819672131147541";"9"
"1918246";"Barry_Smith";"2";"1";"1";"1";"1";"2";"0";"0";"null";"null";"0.5";"0.5";"0.5";"0.5";"1.0";"0.0";"0.0";"1"
"2319647";"YF1";"22";"21";"1";"21";"1";"22";"0";"0";"null";"null";"0.9545454545454546";"0.045454545454545456";"0.9545454545454546";"0.045454545454545456";"1.0";"0.0";"0.0";"4"
"5035278";"Sotantra99";"3";"0";"3";"2";"1";"2";"1";"0";"null";"null";"0.0";"1.0";"0.6666666666666666";"0.3333333333333333";"0.6666666666666666";"0.3333333333333333";"0.0";"1"
"574799";"mpollmeier";"2";"1";"1";"1";"1";"2";"0";"0";"null";"null";"0.5";"0.5";"0.5";"0.5";"1.0";"0.0";"0.0";"1"
"4326661";"Belinda Johnstone";"3";"2";"1";"2";"1";"3";"0";"0";"null";"null";"0.6666666666666666";"0.3333333333333333";"0.6666666666666666";"0.3333333333333333";"1.0";"0.0";"0.0";"3"
"2901345";"Rameshwar Pandit";"27";"0";"27";"0";"27";"24";"3";"2";"null";"null";"0.0";"1.0";"0.0";"1.0";"0.8888888888888888";"0.1111111111111111";"0.07407407407407407";"11"
"2884988";"Emalong";"927";"22";"905";"904";"23";"890";"37";"12";"null";"null";"0.023732470334412083";"0.9762675296655879";"0.9751887810140237";"0.02481121898597627";"0.9600862998921251";"0.039913700107874865";"0.012944983818770227";"9"
"2909567";"VickyHanessian";"4";"0";"4";"3";"1";"4";"0";"0";"null";"null";"0.0";"1.0";"0.75";"0.25";"1.0";"0.0";"0.0";"1"
"4936984";"Sarojkarki";"3";"2";"1";"2";"1";"2";"1";"0";"null";"null";"0.6666666666666666";"0.3333333333333333";"0.6666666666666666";"0.3333333333333333";"0.6666666666666666";"0.3333333333333333";"0.0";"1"
"4990232";"बिज्ञान लामा";"1";"0";"1";"0";"1";"1";"0";"0";"null";"null";"0.0";"1.0";"0.0";"1.0";"1.0";"0.0";"0.0";"1"
"984408";"onurgu";"12";"0";"12";"11";"1";"12";"0";"0";"null";"null";"0.0";"1.0";"0.9166666666666666";"0.08333333333333333";"1.0";"0.0";"0.0";"1"
"3642735";"Nodes&Roads";"290";"6";"284";"289";"1";"66";"224";"35";"null";"null";"0.020689655172413793";"0.9793103448275862";"0.996551724137931";"0.0034482758620689655";"0.22758620689655173";"0.7724137931034483";"0.1206896551724138";"24"
"4797716";"sushil adhikari";"1";"0";"1";"0";"1";"1";"0";"0";"null";"null";"0.0";"1.0";"0.0";"1.0";"1.0";"0.0";"0.0";"1"
"54624";"spatialbits";"224";"0";"224";"223";"1";"93";"131";"0";"null";"null";"0.0";"1.0";"0.9955357142857143";"0.004464285714285714";"0.41517857142857145";"0.5848214285714286";"0.0";"3"
"2864457";"rypat";"21";"20";"1";"20";"1";"21";"0";"0";"null";"null";"0.9523809523809523";"0.047619047619047616";"0.9523809523809523";"0.047619047619047616";"1.0";"0.0";"0.0";"1"
"91490";"Heinz_V";"4094";"2393";"1701";"3216";"878";"827";"3267";"201";"null";"null";"0.5845139228138739";"0.415486077186126";"0.7855398143624817";"0.2144601856375183";"0.20200293111871032";"0.7979970688812897";"0.049096238397655104";"72"
"1910142";"denium";"116";"29";"87";"115";"1";"111";"5";"0";"null";"null";"0.25";"0.75";"0.9913793103448276";"0.008620689655172414";"0.9568965517241379";"0.04310344827586207";"0.0";"8"
"4470055";"Urbin Shrestha";"1";"0";"1";"0";"1";"1";"0";"0";"null";"null";"0.0";"1.0";"0.0";"1.0";"1.0";"0.0";"0.0";"1"
"1148277";"Binod Pandit";"1";"0";"1";"0";"1";"0";"1";"0";"null";"null";"0.0";"1.0";"0.0";"1.0";"0.0";"1.0";"0.0";"1"
"2704719";"TQwill";"47";"0";"47";"46";"1";"47";"0";"0";"null";"null";"0.0";"1.0";"0.9787234042553191";"0.02127659574468085";"1.0";"0.0";"0.0";"2"
"2876738";"ShilpiK";"18";"0";"18";"17";"1";"12";"6";"5";"null";"null";"0.0";"1.0";"0.9444444444444444";"0.05555555555555555";"0.6666666666666666";"0.3333333333333333";"0.2777777777777778";"1"
"4146514";"Prasantb";"1";"0";"1";"0";"1";"1";"0";"0";"null";"null";"0.0";"1.0";"0.0";"1.0";"1.0";"0.0";"0.0";"1"
"2880836";"ccraig321";"10";"0";"10";"9";"1";"10";"0";"0";"null";"null";"0.0";"1.0";"0.9";"0.1";"1.0";"0.0";"0.0";"1"
"226673";"sabman";"4";"3";"1";"3";"1";"4";"0";"0";"null";"null";"0.75";"0.25";"0.75";"0.25";"1.0";"0.0";"0.0";"1"
"2876760";"MohitShrestha";"17";"0";"17";"16";"1";"10";"7";"0";"null";"null";"0.0";"1.0";"0.9411764705882353";"0.058823529411764705";"0.5882352941176471";"0.4117647058823529";"0.0";"4"
"3781966";"Ujwal Maskey";"1";"0";"1";"0";"1";"1";"0";"0";"null";"null";"0.0";"1.0";"0.0";"1.0";"1.0";"0.0";"0.0";"1"
"1283433";"maheshwor1";"2916";"1447";"1469";"2752";"164";"2073";"843";"374";"null";"null";"0.49622770919067216";"0.5037722908093278";"0.943758573388203";"0.056241426611796985";"0.7109053497942387";"0.2890946502057613";"0.12825788751714678";"57"
"2897239";"CPBhattarai";"5";"4";"1";"4";"1";"5";"0";"0";"null";"null";"0.8";"0.2";"0.8";"0.2";"1.0";"0.0";"0.0";"1"
"2876759";"Matt Hewett";"40";"0";"40";"39";"1";"40";"0";"0";"null";"null";"0.0";"1.0";"0.975";"0.025";"1.0";"0.0";"0.0";"5"
"2676054";"corgan555";"4";"3";"1";"3";"1";"4";"0";"0";"null";"null";"0.75";"0.25";"0.75";"0.25";"1.0";"0.0";"0.0";"1"
"750964";"shanker";"28";"0";"28";"0";"28";"7";"21";"0";"null";"null";"0.0";"1.0";"0.0";"1.0";"0.25";"0.75";"0.0";"1"
"284036";"Arunmozhi";"92";"0";"92";"91";"1";"92";"0";"0";"null";"null";"0.0";"1.0";"0.9891304347826086";"0.010869565217391304";"1.0";"0.0";"0.0";"3"
"750985";"Poshan";"292";"83";"209";"249";"43";"179";"113";"27";"null";"null";"0.2842465753424658";"0.7157534246575342";"0.8527397260273972";"0.14726027397260275";"0.613013698630137";"0.386986301369863";"0.09246575342465753";"45"
"5006794";"ajay gole";"1";"0";"1";"0";"1";"1";"0";"0";"null";"null";"0.0";"1.0";"0.0";"1.0";"1.0";"0.0";"0.0";"1"
"2880930";"CharlieWockner";"1";"0";"1";"0";"1";"1";"0";"0";"null";"null";"0.0";"1.0";"0.0";"1.0";"1.0";"0.0";"0.0";"1"
"1417";"maning";"9";"0";"9";"8";"1";"0";"9";"8";"null";"null";"0.0";"1.0";"0.8888888888888888";"0.1111111111111111";"0.0";"1.0";"0.8888888888888888";"1"
"2340266";"Prayag Khanal";"20";"19";"1";"19";"1";"16";"4";"0";"null";"null";"0.95";"0.05";"0.95";"0.05";"0.8";"0.2";"0.0";"1"
"2512300";"samely";"9443";"6895";"2548";"9442";"1";"1817";"7626";"134";"null";"null";"0.7301704966641956";"0.2698295033358043";"0.9998941014508101";"1.0589854918987609E-4";"0.19241766387800488";"0.8075823361219951";"0.014190405591443397";"35"
"1979787";"sraj";"9";"0";"9";"8";"1";"9";"0";"0";"null";"null";"0.0";"1.0";"0.8888888888888888";"0.1111111111111111";"1.0";"0.0";"0.0";"1"
"1811853";"olaf1000";"1";"0";"1";"0";"1";"0";"1";"0";"null";"null";"0.0";"1.0";"0.0";"1.0";"0.0";"1.0";"0.0";"1"
"4404697";"arun48";"3";"2";"1";"2";"1";"3";"0";"0";"null";"null";"0.6666666666666666";"0.3333333333333333";"0.6666666666666666";"0.3333333333333333";"1.0";"0.0";"0.0";"1"
"2864567";"Tob Kim";"299";"0";"299";"0";"299";"218";"81";"1";"null";"null";"0.0";"1.0";"0.0";"1.0";"0.7290969899665551";"0.2709030100334448";"0.0033444816053511705";"1"
"2876854";"erikavetter";"1";"0";"1";"0";"1";"0";"1";"0";"null";"null";"0.0";"1.0";"0.0";"1.0";"0.0";"1.0";"0.0";"1"
"4339167";"OneStopNodeShop";"4";"0";"4";"3";"1";"2";"2";"0";"null";"null";"0.0";"1.0";"0.75";"0.25";"0.5";"0.5";"0.0";"2"
"2876808";"Mike Glyde";"492";"491";"1";"491";"1";"423";"69";"16";"null";"null";"0.9979674796747967";"0.0020325203252032522";"0.9979674796747967";"0.0020325203252032522";"0.8597560975609756";"0.1402439024390244";"0.032520325203252036";"33"
"2573697";"mountainworldtreks";"1";"0";"1";"0";"1";"0";"1";"0";"null";"null";"0.0";"1.0";"0.0";"1.0";"0.0";"1.0";"0.0";"1"
"2860428";"C_Smith";"174";"0";"174";"156";"18";"174";"0";"0";"null";"null";"0.0";"1.0";"0.896551724137931";"0.10344827586206896";"1.0";"0.0";"0.0";"7"
"2864515";"tinymoon3210";"136";"0";"136";"135";"1";"136";"0";"0";"null";"null";"0.0";"1.0";"0.9926470588235294";"0.007352941176470588";"1.0";"0.0";"0.0";"4"
"2631041";"tkf sisqo";"49";"0";"49";"0";"49";"49";"0";"0";"null";"null";"0.0";"1.0";"0.0";"1.0";"1.0";"0.0";"0.0";"1"
"136617";"AngrezBaba";"7";"0";"7";"6";"1";"2";"5";"0";"null";"null";"0.0";"1.0";"0.8571428571428571";"0.14285714285714285";"0.2857142857142857";"0.7142857142857143";"0.0";"2"
"300459";"didier2020";"170";"0";"170";"0";"170";"0";"170";"170";"null";"null";"0.0";"1.0";"0.0";"1.0";"0.0";"1.0";"1.0";"1"
"2872730";"Sujal Dhungana";"7";"0";"7";"6";"1";"7";"0";"0";"null";"null";"0.0";"1.0";"0.8571428571428571";"0.14285714285714285";"1.0";"0.0";"0.0";"2"
"2303383";"Ashish Batajoo";"6";"5";"1";"5";"1";"3";"3";"3";"null";"null";"0.8333333333333334";"0.16666666666666666";"0.8333333333333334";"0.16666666666666666";"0.5";"0.5";"0.5";"2"
"2119063";"MappingDrone";"898";"897";"1";"897";"1";"731";"167";"16";"null";"null";"0.9988864142538976";"0.0011135857461024498";"0.9988864142538976";"0.0011135857461024498";"0.8140311804008908";"0.18596881959910913";"0.017817371937639197";"11"
"456113";"eric_G";"23";"22";"1";"22";"1";"16";"7";"7";"null";"null";"0.9565217391304348";"0.043478260869565216";"0.9565217391304348";"0.043478260869565216";"0.6956521739130435";"0.30434782608695654";"0.30434782608695654";"1"
"996790";"Hagellach37";"145";"0";"145";"144";"1";"143";"2";"0";"null";"null";"0.0";"1.0";"0.993103448275862";"0.006896551724137931";"0.9862068965517241";"0.013793103448275862";"0.0";"7"
"2876816";"Paigeist";"116";"0";"116";"115";"1";"116";"0";"0";"null";"null";"0.0";"1.0";"0.9913793103448276";"0.008620689655172414";"1.0";"0.0";"0.0";"6"
"2876822";"dschroet";"26";"0";"26";"25";"1";"26";"0";"0";"null";"null";"0.0";"1.0";"0.9615384615384616";"0.038461538461538464";"1.0";"0.0";"0.0";"2"
"2872725";"andyshrestha";"1";"0";"1";"0";"1";"0";"1";"0";"null";"null";"0.0";"1.0";"0.0";"1.0";"0.0";"1.0";"0.0";"1"
"2536857";"deskworld";"8";"0";"8";"7";"1";"0";"8";"8";"null";"null";"0.0";"1.0";"0.875";"0.125";"0.0";"1.0";"1.0";"1"
"1213904";"mpmckenna8";"371";"0";"371";"370";"1";"360";"11";"3";"null";"null";"0.0";"1.0";"0.9973045822102425";"0.0026954177897574125";"0.9703504043126685";"0.029649595687331536";"0.008086253369272238";"9"
"3286513";"amigotreks";"2";"1";"1";"1";"1";"1";"1";"0";"null";"null";"0.5";"0.5";"0.5";"0.5";"0.5";"0.5";"0.0";"2"
"1205717";"Rajan Kandel";"1";"0";"1";"0";"1";"1";"0";"0";"null";"null";"0.0";"1.0";"0.0";"1.0";"1.0";"0.0";"0.0";"1"
"4158965";"CHHUNU";"8";"2";"6";"5";"3";"6";"2";"0";"null";"null";"0.25";"0.75";"0.625";"0.375";"0.75";"0.25";"0.0";"5"
"4568456";"Aabhushan Shrestha";"2";"1";"1";"1";"1";"2";"0";"0";"null";"null";"0.5";"0.5";"0.5";"0.5";"1.0";"0.0";"0.0";"1"
"4760967";"EditingEditor";"4";"0";"4";"3";"1";"1";"3";"0";"null";"null";"0.0";"1.0";"0.75";"0.25";"0.25";"0.75";"0.0";"1"
"4507028";"Binish";"1";"0";"1";"0";"1";"1";"0";"0";"null";"null";"0.0";"1.0";"0.0";"1.0";"1.0";"0.0";"0.0";"1"
"3573216";"Bishal9841";"5860";"3900";"1960";"4856";"1004";"937";"4923";"643";"null";"null";"0.6655290102389079";"0.33447098976109213";"0.8286689419795222";"0.17133105802047782";"0.1598976109215017";"0.8401023890784983";"0.10972696245733789";"48"
"419280";"oconnorholmesbailey";"70";"0";"70";"69";"1";"69";"1";"0";"null";"null";"0.0";"1.0";"0.9857142857142858";"0.014285714285714285";"0.9857142857142858";"0.014285714285714285";"0.0";"4"
"2201078";"buga4ever";"60";"59";"1";"59";"1";"60";"0";"0";"null";"null";"0.9833333333333333";"0.016666666666666666";"0.9833333333333333";"0.016666666666666666";"1.0";"0.0";"0.0";"2"
"4646310";"Devildnes";"1";"0";"1";"0";"1";"1";"0";"0";"null";"null";"0.0";"1.0";"0.0";"1.0";"1.0";"0.0";"0.0";"1"
"751081";"Biplov Bhandari";"395";"101";"294";"340";"55";"118";"277";"59";"null";"null";"0.25569620253164554";"0.7443037974683544";"0.8607594936708861";"0.13924050632911392";"0.29873417721518986";"0.7012658227848101";"0.14936708860759493";"18"
"181728";"JustinColeGIS";"109";"0";"109";"108";"1";"109";"0";"0";"null";"null";"0.0";"1.0";"0.9908256880733946";"0.009174311926605505";"1.0";"0.0";"0.0";"1"
"2876878";"nmandel";"12";"0";"12";"11";"1";"12";"0";"0";"null";"null";"0.0";"1.0";"0.9166666666666666";"0.08333333333333333";"1.0";"0.0";"0.0";"2"
"751085";"knz";"3";"0";"3";"2";"1";"3";"0";"0";"null";"null";"0.0";"1.0";"0.6666666666666666";"0.3333333333333333";"1.0";"0.0";"0.0";"1"
"2622913";"Medi Quest Laboratory Clinic";"2";"0";"2";"1";"1";"2";"0";"0";"null";"null";"0.0";"1.0";"0.5";"0.5";"1.0";"0.0";"0.0";"1"
"2479566";"Yezimala";"5";"4";"1";"0";"5";"4";"1";"1";"null";"null";"0.8";"0.2";"0.0";"1.0";"0.8";"0.2";"0.2";"3"
"3061186";"karinekasti";"4";"0";"4";"3";"1";"4";"0";"0";"null";"null";"0.0";"1.0";"0.75";"0.25";"1.0";"0.0";"0.0";"1"
"2909633";"69AD";"11729";"940";"10789";"11728";"1";"5574";"6155";"3982";"null";"null";"0.08014323471736721";"0.9198567652826328";"0.9999147412396624";"8.525876033762469E-5";"0.47523233012192";"0.52476766987808";"0.33950038366442153";"21"
"2459080";"Manir";"11";"10";"1";"10";"1";"10";"1";"1";"null";"null";"0.9090909090909091";"0.09090909090909091";"0.9090909090909091";"0.09090909090909091";"0.9090909090909091";"0.09090909090909091";"0.09090909090909091";"2"
"2876889";"aprildh31";"117";"116";"1";"0";"117";"83";"34";"3";"null";"null";"0.9914529914529915";"0.008547008547008548";"0.0";"1.0";"0.7094017094017094";"0.2905982905982906";"0.02564102564102564";"1"
"2860508";"Gabix";"22";"21";"1";"0";"22";"22";"0";"0";"null";"null";"0.9545454545454546";"0.045454545454545456";"0.0";"1.0";"1.0";"0.0";"0.0";"3"
"2479581";"sanjaydhami";"28";"23";"5";"12";"16";"8";"20";"7";"null";"null";"0.8214285714285714";"0.17857142857142858";"0.42857142857142855";"0.5714285714285714";"0.2857142857142857";"0.7142857142857143";"0.25";"4"
"4453818";"Durjoy";"4";"0";"4";"3";"1";"4";"0";"0";"null";"null";"0.0";"1.0";"0.75";"0.25";"1.0";"0.0";"0.0";"1"
"2876882";"Cristine Kores";"68";"0";"68";"67";"1";"61";"7";"7";"null";"null";"0.0";"1.0";"0.9852941176470589";"0.014705882352941176";"0.8970588235294118";"0.10294117647058823";"0.10294117647058823";"1"
"2872785";"senora_barberan";"114";"0";"114";"113";"1";"113";"1";"0";"null";"null";"0.0";"1.0";"0.9912280701754386";"0.008771929824561403";"0.9912280701754386";"0.008771929824561403";"0.0";"5"
"751088";"sureshmdhr";"1";"0";"1";"0";"1";"1";"0";"0";"null";"null";"0.0";"1.0";"0.0";"1.0";"1.0";"0.0";"0.0";"1"
"2332125";"Eysler";"17";"0";"17";"16";"1";"17";"0";"0";"null";"null";"0.0";"1.0";"0.9411764705882353";"0.058823529411764705";"1.0";"0.0";"0.0";"1"
"1570327";"Raw Bin Tamang";"3";"0";"3";"0";"3";"1";"2";"1";"null";"null";"0.0";"1.0";"0.0";"1.0";"0.3333333333333333";"0.6666666666666666";"0.3333333333333333";"2"
"574986";"longestway";"20";"3";"17";"19";"1";"20";"0";"0";"null";"null";"0.15";"0.85";"0.95";"0.05";"1.0";"0.0";"0.0";"4"
"2876969";"mhsMapper";"4";"0";"4";"0";"4";"4";"0";"0";"null";"null";"0.0";"1.0";"0.0";"1.0";"1.0";"0.0";"0.0";"1"
"2303520";"Sunil Sah";"177";"119";"58";"57";"120";"167";"10";"2";"null";"null";"0.672316384180791";"0.327683615819209";"0.3220338983050847";"0.6779661016949152";"0.943502824858757";"0.05649717514124294";"0.011299435028248588";"5"
"3827260";"Sanjay Shahi";"1";"0";"1";"0";"1";"1";"0";"0";"null";"null";"0.0";"1.0";"0.0";"1.0";"1.0";"0.0";"0.0";"1"
"2016793";"karkijitesh";"1";"0";"1";"0";"1";"0";"1";"0";"null";"null";"0.0";"1.0";"0.0";"1.0";"0.0";"1.0";"0.0";"1"
"3790385";"Raman Sijakhwa";"2";"0";"2";"1";"1";"1";"1";"0";"null";"null";"0.0";"1.0";"0.5";"0.5";"0.5";"0.5";"0.0";"2"
"2926117";"m-rekibou";"12";"11";"1";"11";"1";"6";"6";"6";"null";"null";"0.9166666666666666";"0.08333333333333333";"0.9166666666666666";"0.08333333333333333";"0.5";"0.5";"0.5";"2"
"2868770";"Nayan Malla";"63";"62";"1";"62";"1";"41";"22";"6";"null";"null";"0.9841269841269841";"0.015873015873015872";"0.9841269841269841";"0.015873015873015872";"0.6507936507936508";"0.3492063492063492";"0.09523809523809523";"1"
"185864";"avashnirvana";"1";"0";"1";"0";"1";"1";"0";"0";"null";"null";"0.0";"1.0";"0.0";"1.0";"1.0";"0.0";"0.0";"1"
"2881087";"Mo_theStargazer";"37";"22";"15";"14";"23";"25";"12";"11";"null";"null";"0.5945945945945946";"0.40540540540540543";"0.3783783783783784";"0.6216216216216216";"0.6756756756756757";"0.32432432432432434";"0.2972972972972973";"4"
"562704";"Anil Pokhrel";"4";"0";"4";"3";"1";"4";"0";"0";"null";"null";"0.0";"1.0";"0.75";"0.25";"1.0";"0.0";"0.0";"1"
"3057202";"pramod2c";"1";"0";"1";"0";"1";"1";"0";"0";"null";"null";"0.0";"1.0";"0.0";"1.0";"1.0";"0.0";"0.0";"1"
"2790964";"sushmit sarmah";"11";"0";"11";"10";"1";"11";"0";"0";"null";"null";"0.0";"1.0";"0.9090909090909091";"0.09090909090909091";"1.0";"0.0";"0.0";"1"
"4892244";"Jiban raj Poudel";"1";"0";"1";"0";"1";"1";"0";"0";"null";"null";"0.0";"1.0";"0.0";"1.0";"1.0";"0.0";"0.0";"1"
"2516487";"Pujan Poudyal";"1193";"911";"282";"982";"211";"946";"247";"185";"null";"null";"0.7636211232187762";"0.2363788767812238";"0.8231349538977368";"0.1768650461022632";"0.7929589270746018";"0.20704107292539817";"0.1550712489522213";"21"
"132640";"tilt";"73";"72";"1";"0";"73";"69";"4";"0";"null";"null";"0.9863013698630136";"0.0136986301369863";"0.0";"1.0";"0.9452054794520548";"0.0547945205479452";"0.0";"1"
"2303499";"TAKASHI TANAKA";"1440";"752";"688";"525";"915";"980";"460";"271";"null";"null";"0.5222222222222223";"0.4777777777777778";"0.3645833333333333";"0.6354166666666666";"0.6805555555555556";"0.3194444444444444";"0.18819444444444444";"16"
"2266634";"ajithkarunaratne";"3";"0";"3";"0";"3";"1";"2";"0";"null";"null";"0.0";"1.0";"0.0";"1.0";"0.3333333333333333";"0.6666666666666666";"0.0";"2"
"2885120";"gallileo 19";"16";"15";"1";"0";"16";"16";"0";"0";"null";"null";"0.9375";"0.0625";"0.0";"1.0";"1.0";"0.0";"0.0";"1"
"4072979";"Pheonixfinman";"4";"0";"4";"3";"1";"3";"1";"0";"null";"null";"0.0";"1.0";"0.75";"0.25";"0.75";"0.25";"0.0";"3"
"4863591";"ES OR";"1";"0";"1";"0";"1";"1";"0";"0";"null";"null";"0.0";"1.0";"0.0";"1.0";"1.0";"0.0";"0.0";"1"
"128559";"boudjere";"100";"99";"1";"99";"1";"100";"0";"0";"null";"null";"0.99";"0.01";"0.99";"0.01";"1.0";"0.0";"0.0";"1"
"4544115";"Meelan Dhamala";"1";"0";"1";"0";"1";"1";"0";"0";"null";"null";"0.0";"1.0";"0.0";"1.0";"1.0";"0.0";"0.0";"1"
"2016801";"PaulDK";"618";"525";"93";"598";"20";"410";"208";"60";"null";"null";"0.8495145631067961";"0.15048543689320387";"0.9676375404530745";"0.032362459546925564";"0.6634304207119741";"0.3365695792880259";"0.0970873786407767";"111"
"2557538";"Dibloni Innocent";"658";"267";"391";"0";"658";"431";"227";"0";"null";"null";"0.40577507598784196";"0.5942249240121581";"0.0";"1.0";"0.6550151975683891";"0.34498480243161095";"0.0";"54"
"4494849";"Pratiksha Khanal Rawlings";"2";"0";"2";"0";"2";"2";"0";"0";"null";"null";"0.0";"1.0";"0.0";"1.0";"1.0";"0.0";"0.0";"2"
"1893974";"Vivek Bhusal";"24";"23";"1";"23";"1";"12";"12";"0";"null";"null";"0.9583333333333334";"0.041666666666666664";"0.9583333333333334";"0.041666666666666664";"0.5";"0.5";"0.0";"2"
"2864736";"aleciuc";"140";"0";"140";"139";"1";"138";"2";"0";"null";"null";"0.0";"1.0";"0.9928571428571429";"0.007142857142857143";"0.9857142857142858";"0.014285714285714285";"0.0";"3"
"4908570";"Nirmal Dulal";"1";"0";"1";"0";"1";"1";"0";"0";"null";"null";"0.0";"1.0";"0.0";"1.0";"1.0";"0.0";"0.0";"1"
"34386";"rdelach";"596";"0";"596";"595";"1";"541";"55";"8";"null";"null";"0.0";"1.0";"0.9983221476510067";"0.0016778523489932886";"0.9077181208053692";"0.09228187919463088";"0.013422818791946308";"1"
"2877054";"gatthaghar";"5";"0";"5";"4";"1";"5";"0";"0";"null";"null";"0.0";"1.0";"0.8";"0.2";"1.0";"0.0";"0.0";"1"
"3569249";"Parassrest";"2444";"1214";"1230";"1683";"761";"1133";"1311";"100";"null";"null";"0.4967266775777414";"0.5032733224222586";"0.6886252045826514";"0.3113747954173486";"0.4635842880523732";"0.5364157119476268";"0.04091653027823241";"36"
"4199960";"mavensony";"19";"0";"19";"0";"19";"15";"4";"0";"null";"null";"0.0";"1.0";"0.0";"1.0";"0.7894736842105263";"0.21052631578947367";"0.0";"1"
"2909812";"Daniel  Rodriguez";"8";"7";"1";"7";"1";"8";"0";"0";"null";"null";"0.875";"0.125";"0.875";"0.125";"1.0";"0.0";"0.0";"1"
"2877043";"anyaw";"59";"0";"59";"58";"1";"45";"14";"0";"null";"null";"0.0";"1.0";"0.9830508474576272";"0.01694915254237288";"0.7627118644067796";"0.23728813559322035";"0.0";"2"
"4777489";"nier lama";"2";"0";"2";"1";"1";"2";"0";"0";"null";"null";"0.0";"1.0";"0.5";"0.5";"1.0";"0.0";"0.0";"2"
"2877040";"Seagoat";"2";"0";"2";"1";"1";"2";"0";"0";"null";"null";"0.0";"1.0";"0.5";"0.5";"1.0";"0.0";"0.0";"1"
"3790437";"Roots bar";"2";"0";"2";"1";"1";"1";"1";"0";"null";"null";"0.0";"1.0";"0.5";"0.5";"0.5";"0.5";"0.0";"2"
"1209932";"oddityoverseer";"67";"0";"67";"66";"1";"67";"0";"0";"null";"null";"0.0";"1.0";"0.9850746268656716";"0.014925373134328358";"1.0";"0.0";"0.0";"1"
"2897523";"libbybush";"13";"12";"1";"12";"1";"13";"0";"0";"null";"null";"0.9230769230769231";"0.07692307692307693";"0.9230769230769231";"0.07692307692307693";"1.0";"0.0";"0.0";"1"
"2877000";"juty4074";"344";"0";"344";"343";"1";"344";"0";"0";"null";"null";"0.0";"1.0";"0.997093023255814";"0.0029069767441860465";"1.0";"0.0";"0.0";"1"
"1062517";"MartinHoset";"59";"0";"59";"58";"1";"43";"16";"8";"null";"null";"0.0";"1.0";"0.9830508474576272";"0.01694915254237288";"0.7288135593220338";"0.2711864406779661";"0.13559322033898305";"2"
"4953633";"김서림";"1";"0";"1";"0";"1";"0";"1";"0";"null";"null";"0.0";"1.0";"0.0";"1.0";"0.0";"1.0";"0.0";"1"
"4109908";"akstha";"1";"0";"1";"0";"1";"1";"0";"0";"null";"null";"0.0";"1.0";"0.0";"1.0";"1.0";"0.0";"0.0";"1"
"34411";"gormo";"162";"161";"1";"161";"1";"147";"15";"1";"null";"null";"0.9938271604938271";"0.006172839506172839";"0.9938271604938271";"0.006172839506172839";"0.9074074074074074";"0.09259259259259259";"0.006172839506172839";"8"
"644706";"joehand";"62";"0";"62";"61";"1";"62";"0";"0";"null";"null";"0.0";"1.0";"0.9838709677419355";"0.016129032258064516";"1.0";"0.0";"0.0";"1"
"2881088";"StephenMangum";"10";"0";"10";"9";"1";"10";"0";"0";"null";"null";"0.0";"1.0";"0.9";"0.1";"1.0";"0.0";"0.0";"1"
"3274332";"uncivilized";"36";"0";"36";"35";"1";"19";"17";"14";"null";"null";"0.0";"1.0";"0.9722222222222222";"0.027777777777777776";"0.5277777777777778";"0.4722222222222222";"0.3888888888888889";"2"
"2889282";"SwetaP";"16";"15";"1";"15";"1";"16";"0";"0";"null";"null";"0.9375";"0.0625";"0.9375";"0.0625";"1.0";"0.0";"0.0";"2"
"1586794";"AKE Amazan";"198";"141";"57";"0";"198";"198";"0";"0";"null";"null";"0.7121212121212122";"0.2878787878787879";"0.0";"1.0";"1.0";"0.0";"0.0";"9"
"4351536";"Bidhan11";"3";"2";"1";"0";"3";"3";"0";"0";"null";"null";"0.6666666666666666";"0.3333333333333333";"0.0";"1.0";"1.0";"0.0";"0.0";"1"
"4589109";"Abinash Thapa Magar";"13";"0";"13";"0";"13";"13";"0";"0";"null";"null";"0.0";"1.0";"0.0";"1.0";"1.0";"0.0";"0.0";"2"
"3274306";"saksham9841";"17";"10";"7";"16";"1";"14";"3";"1";"null";"null";"0.5882352941176471";"0.4117647058823529";"0.9411764705882353";"0.058823529411764705";"0.8235294117647058";"0.17647058823529413";"0.058823529411764705";"3"
"3274308";"Arjun Poudel";"4";"0";"4";"3";"1";"3";"1";"0";"null";"null";"0.0";"1.0";"0.75";"0.25";"0.75";"0.25";"0.0";"1"
"2897493";"Neissa";"330";"329";"1";"329";"1";"328";"2";"0";"null";"null";"0.996969696969697";"0.0030303030303030303";"0.996969696969697";"0.0030303030303030303";"0.9939393939393939";"0.006060606060606061";"0.0";"2"
"75388";"Svalbard";"73";"72";"1";"71";"2";"0";"73";"13";"null";"null";"0.9863013698630136";"0.0136986301369863";"0.9726027397260274";"0.0273972602739726";"0.0";"1.0";"0.1780821917808219";"7"
"2877013";"Sabaziadlou";"6";"0";"6";"5";"1";"6";"0";"0";"null";"null";"0.0";"1.0";"0.8333333333333334";"0.16666666666666666";"1.0";"0.0";"0.0";"1"
"358021";"danafer";"37";"29";"8";"36";"1";"37";"0";"0";"null";"null";"0.7837837837837838";"0.21621621621621623";"0.972972972972973";"0.02702702702702703";"1.0";"0.0";"0.0";"3"
"63107";"brogo";"44";"6";"38";"43";"1";"3";"41";"32";"null";"null";"0.13636363636363635";"0.8636363636363636";"0.9772727272727273";"0.022727272727272728";"0.06818181818181818";"0.9318181818181818";"0.7272727272727273";"2"
"2377377";"abel801";"2359";"3";"2356";"2358";"1";"1109";"1250";"188";"null";"null";"0.001271725307333616";"0.9987282746926663";"0.9995760915642221";"4.23908435777872E-4";"0.47011445527766005";"0.52988554472234";"0.07969478592623994";"14"
"2889385";"hunterellens";"24";"23";"1";"23";"1";"23";"1";"0";"null";"null";"0.9583333333333334";"0.041666666666666664";"0.9583333333333334";"0.041666666666666664";"0.9583333333333334";"0.041666666666666664";"0.0";"6"
"1218199";"Richard Folly";"82";"0";"82";"0";"82";"82";"0";"0";"null";"null";"0.0";"1.0";"0.0";"1.0";"1.0";"0.0";"0.0";"5"
"1414812";"RAytoun";"424";"423";"1";"423";"1";"287";"137";"32";"null";"null";"0.9976415094339622";"0.0023584905660377358";"0.9976415094339622";"0.0023584905660377358";"0.6768867924528302";"0.3231132075471698";"0.07547169811320754";"18"
"439947";"StephaneP";"139";"0";"139";"138";"1";"139";"0";"0";"null";"null";"0.0";"1.0";"0.9928057553956835";"0.007194244604316547";"1.0";"0.0";"0.0";"1"
"2807484";"Kiran Shakya";"20";"19";"1";"0";"20";"7";"13";"1";"null";"null";"0.95";"0.05";"0.0";"1.0";"0.35";"0.65";"0.05";"4"
"1050248";"geocruizer";"40";"0";"40";"39";"1";"29";"11";"0";"null";"null";"0.0";"1.0";"0.975";"0.025";"0.725";"0.275";"0.0";"2"
"1468043";"jengelh";"2";"1";"1";"0";"2";"0";"2";"0";"null";"null";"0.5";"0.5";"0.0";"1.0";"0.0";"1.0";"0.0";"1"
"136860";"indigomc";"1";"0";"1";"0";"1";"0";"1";"0";"null";"null";"0.0";"1.0";"0.0";"1.0";"0.0";"1.0";"0.0";"1"
"2020993";"drehrumbum71";"578";"577";"1";"577";"1";"511";"67";"7";"null";"null";"0.9982698961937716";"0.0017301038062283738";"0.9982698961937716";"0.0017301038062283738";"0.884083044982699";"0.11591695501730104";"0.012110726643598616";"12"
"3274387";"amrit_agg";"1";"0";"1";"0";"1";"1";"0";"0";"null";"null";"0.0";"1.0";"0.0";"1.0";"1.0";"0.0";"0.0";"1"
"2868873";"Jack_Williams";"12";"11";"1";"11";"1";"12";"0";"0";"null";"null";"0.9166666666666666";"0.08333333333333333";"0.9166666666666666";"0.08333333333333333";"1.0";"0.0";"0.0";"1"
"4515553";"sachit shrestha";"2";"1";"1";"1";"1";"0";"2";"0";"null";"null";"0.5";"0.5";"0.5";"0.5";"0.0";"1.0";"0.0";"2"
"4126359";"Satish Shakya";"3";"1";"2";"2";"1";"3";"0";"0";"null";"null";"0.3333333333333333";"0.6666666666666666";"0.6666666666666666";"0.3333333333333333";"1.0";"0.0";"0.0";"2"
"1554107";"jgpacker";"7";"0";"7";"6";"1";"0";"7";"0";"null";"null";"0.0";"1.0";"0.8571428571428571";"0.14285714285714285";"0.0";"1.0";"0.0";"1"
"4736741";"Sudip Kafle";"1";"0";"1";"0";"1";"1";"0";"0";"null";"null";"0.0";"1.0";"0.0";"1.0";"1.0";"0.0";"0.0";"1"
"3999379";"AADHYA";"1";"0";"1";"0";"1";"1";"0";"0";"null";"null";"0.0";"1.0";"0.0";"1.0";"1.0";"0.0";"0.0";"1"
"4716279";"Tebaj";"1";"0";"1";"0";"1";"1";"0";"0";"null";"null";"0.0";"1.0";"0.0";"1.0";"1.0";"0.0";"0.0";"1"
"3892875";"Sameer Dhakal";"2";"0";"2";"0";"2";"2";"0";"0";"null";"null";"0.0";"1.0";"0.0";"1.0";"1.0";"0.0";"0.0";"2"
"2877083";"Christian Fernandez MX";"82";"0";"82";"81";"1";"82";"0";"0";"null";"null";"0.0";"1.0";"0.9878048780487805";"0.012195121951219513";"1.0";"0.0";"0.0";"2"
"2864793";"MrLyster";"614";"0";"614";"613";"1";"614";"0";"0";"null";"null";"0.0";"1.0";"0.998371335504886";"0.0016286644951140066";"1.0";"0.0";"0.0";"5"
"1947311";"aasish";"15";"0";"15";"14";"1";"5";"10";"5";"null";"null";"0.0";"1.0";"0.9333333333333333";"0.06666666666666667";"0.3333333333333333";"0.6666666666666666";"0.3333333333333333";"4"
"2279062";"RuesI";"61";"60";"1";"0";"61";"61";"0";"0";"null";"null";"0.9836065573770492";"0.01639344262295082";"0.0";"1.0";"1.0";"0.0";"0.0";"1"
"26299";"uboot";"1";"0";"1";"0";"1";"0";"1";"0";"null";"null";"0.0";"1.0";"0.0";"1.0";"0.0";"1.0";"0.0";"1"
"2279068";"raaz";"59";"58";"1";"0";"59";"55";"4";"1";"null";"null";"0.9830508474576272";"0.01694915254237288";"0.0";"1.0";"0.9322033898305084";"0.06779661016949153";"0.01694915254237288";"2"
"1484502";"foxrobs";"917";"0";"917";"916";"1";"851";"66";"27";"null";"null";"0.0";"1.0";"0.9989094874591058";"0.0010905125408942203";"0.9280261723009815";"0.07197382769901854";"0.029443838604143947";"17"
"353988";"venza";"21";"0";"21";"0";"21";"1";"20";"8";"null";"null";"0.0";"1.0";"0.0";"1.0";"0.047619047619047616";"0.9523809523809523";"0.38095238095238093";"3"
"4826764";"Racaes Singh";"1";"0";"1";"0";"1";"1";"0";"0";"null";"null";"0.0";"1.0";"0.0";"1.0";"1.0";"0.0";"0.0";"1"
"4982404";"Suman Raj Tuladhar";"2";"1";"1";"0";"2";"2";"0";"0";"null";"null";"0.5";"0.5";"0.0";"1.0";"1.0";"0.0";"0.0";"1"
"4589199";"MayaRajeev";"11";"0";"11";"0";"11";"11";"0";"0";"null";"null";"0.0";"1.0";"0.0";"1.0";"1.0";"0.0";"0.0";"1"
"4392584";"Prabin Ghimire";"1";"0";"1";"0";"1";"1";"0";"0";"null";"null";"0.0";"1.0";"0.0";"1.0";"1.0";"0.0";"0.0";"1"
"4789912";"Pradip Khatiwada";"21";"0";"21";"20";"1";"17";"4";"1";"null";"null";"0.0";"1.0";"0.9523809523809523";"0.047619047619047616";"0.8095238095238095";"0.19047619047619047";"0.047619047619047616";"6"
"14034";"mikecc";"949";"578";"371";"359";"590";"647";"302";"70";"null";"null";"0.6090621707060063";"0.3909378292939937";"0.37829293993677554";"0.6217070600632244";"0.6817702845100105";"0.31822971548998946";"0.0737618545837724";"35"
"4253333";"charlie bhagat";"636";"635";"1";"635";"1";"636";"0";"0";"null";"null";"0.9984276729559748";"0.0015723270440251573";"0.9984276729559748";"0.0015723270440251573";"1.0";"0.0";"0.0";"2"
"4429467";"Armangi";"2";"1";"1";"1";"1";"2";"0";"0";"null";"null";"0.5";"0.5";"0.5";"0.5";"1.0";"0.0";"0.0";"1"
"2774773";"BukuPuku";"15";"1";"14";"13";"2";"8";"7";"6";"null";"null";"0.06666666666666667";"0.9333333333333333";"0.8666666666666667";"0.13333333333333333";"0.5333333333333333";"0.4666666666666667";"0.4";"5"
"2393795";"Daniel Specht";"242";"0";"242";"241";"1";"242";"0";"0";"null";"null";"0.0";"1.0";"0.9958677685950413";"0.004132231404958678";"1.0";"0.0";"0.0";"1"
"2873027";"Serenity1";"876";"875";"1";"875";"1";"872";"4";"0";"null";"null";"0.9988584474885844";"0.001141552511415525";"0.9988584474885844";"0.001141552511415525";"0.9954337899543378";"0.0045662100456621";"0.0";"8"
"3569372";"Ayush Upreti";"3";"1";"2";"2";"1";"1";"2";"1";"null";"null";"0.3333333333333333";"0.6666666666666666";"0.6666666666666666";"0.3333333333333333";"0.3333333333333333";"0.6666666666666666";"0.3333333333333333";"3"
"3938000";"Marshall8989";"3";"2";"1";"1";"2";"3";"0";"0";"null";"null";"0.6666666666666666";"0.3333333333333333";"0.3333333333333333";"0.6666666666666666";"1.0";"0.0";"0.0";"2"
"2545355";"Dornathal";"18";"0";"18";"17";"1";"18";"0";"0";"null";"null";"0.0";"1.0";"0.9444444444444444";"0.05555555555555555";"1.0";"0.0";"0.0";"1"
"2864863";"florianheinkel";"138";"137";"1";"137";"1";"138";"0";"0";"null";"null";"0.9927536231884058";"0.007246376811594203";"0.9927536231884058";"0.007246376811594203";"1.0";"0.0";"0.0";"1"
"3221188";"Vigyan Shah";"1";"0";"1";"0";"1";"1";"0";"0";"null";"null";"0.0";"1.0";"0.0";"1.0";"1.0";"0.0";"0.0";"1"
"1205996";"kdrB";"1";"0";"1";"0";"1";"1";"0";"0";"null";"null";"0.0";"1.0";"0.0";"1.0";"1.0";"0.0";"0.0";"1"
"4019907";"Sudip Katwal";"2";"1";"1";"1";"1";"2";"0";"0";"null";"null";"0.5";"0.5";"0.5";"0.5";"1.0";"0.0";"0.0";"1"
"2389798";"Ophroad";"130";"125";"5";"4";"126";"128";"2";"1";"null";"null";"0.9615384615384616";"0.038461538461538464";"0.03076923076923077";"0.9692307692307692";"0.9846153846153847";"0.015384615384615385";"0.007692307692307693";"5"
"5015374";"Sudikshya Acharya";"1";"0";"1";"0";"1";"1";"0";"0";"null";"null";"0.0";"1.0";"0.0";"1.0";"1.0";"0.0";"0.0";"1"
"4646721";"LEESANGBUM";"2";"0";"2";"1";"1";"2";"0";"0";"null";"null";"0.0";"1.0";"0.5";"0.5";"1.0";"0.0";"0.0";"2"
"1435420";"Binod";"8";"0";"8";"7";"1";"8";"0";"0";"null";"null";"0.0";"1.0";"0.875";"0.125";"1.0";"0.0";"0.0";"1"
"349964";"jmbangate";"2392";"1675";"717";"2391";"1";"2016";"376";"0";"null";"null";"0.7002508361204013";"0.29974916387959866";"0.9995819397993311";"4.180602006688963E-4";"0.842809364548495";"0.15719063545150502";"0.0";"18"
"4892481";"jen bajracharya";"2";"0";"2";"1";"1";"2";"0";"0";"null";"null";"0.0";"1.0";"0.5";"0.5";"1.0";"0.0";"0.0";"2"
"2897696";"Jihoi Lee";"414";"16";"398";"413";"1";"400";"14";"0";"null";"null";"0.03864734299516908";"0.961352657004831";"0.9975845410628019";"0.0024154589371980675";"0.966183574879227";"0.033816425120772944";"0.0";"54"
"2180909";"zekenx";"5";"0";"5";"0";"5";"5";"0";"0";"null";"null";"0.0";"1.0";"0.0";"1.0";"1.0";"0.0";"0.0";"2"
"2324270";"Maharjan";"51";"44";"7";"50";"1";"12";"39";"31";"null";"null";"0.8627450980392157";"0.13725490196078433";"0.9803921568627451";"0.0196078431372549";"0.23529411764705882";"0.7647058823529411";"0.6078431372549019";"3"
"108303";"nivlac_sebboh";"7";"0";"7";"6";"1";"7";"0";"0";"null";"null";"0.0";"1.0";"0.8571428571428571";"0.14285714285714285";"1.0";"0.0";"0.0";"1"
"1058591";"mvaldivia";"89";"0";"89";"88";"1";"88";"1";"0";"null";"null";"0.0";"1.0";"0.9887640449438202";"0.011235955056179775";"0.9887640449438202";"0.011235955056179775";"0.0";"14"
"2180916";"panga456123";"57";"0";"57";"0";"57";"42";"15";"0";"null";"null";"0.0";"1.0";"0.0";"1.0";"0.7368421052631579";"0.2631578947368421";"0.0";"7"
"3700514";"Aavas";"3";"0";"3";"2";"1";"3";"0";"0";"null";"null";"0.0";"1.0";"0.6666666666666666";"0.3333333333333333";"1.0";"0.0";"0.0";"1"
"3643181";"grek1990smile";"1";"0";"1";"0";"1";"1";"0";"0";"null";"null";"0.0";"1.0";"0.0";"1.0";"1.0";"0.0";"0.0";"1"
"2910006";"cfortunska";"23";"0";"23";"22";"1";"23";"0";"0";"null";"null";"0.0";"1.0";"0.9565217391304348";"0.043478260869565216";"1.0";"0.0";"0.0";"1"
"2090756";"Milzze Baniya";"5";"0";"5";"0";"5";"5";"0";"0";"null";"null";"0.0";"1.0";"0.0";"1.0";"1.0";"0.0";"0.0";"1"
"2008834";"vicapiert";"355";"0";"355";"354";"1";"349";"6";"5";"null";"null";"0.0";"1.0";"0.9971830985915493";"0.0028169014084507044";"0.9830985915492958";"0.016901408450704224";"0.014084507042253521";"2"
"2873103";"Saroj Joshi";"4";"0";"4";"3";"1";"0";"4";"0";"null";"null";"0.0";"1.0";"0.75";"0.25";"0.0";"1.0";"0.0";"1"
"444194";"Gulyás Kálmán";"1";"0";"1";"0";"1";"1";"0";"0";"null";"null";"0.0";"1.0";"0.0";"1.0";"1.0";"0.0";"0.0";"1"
"2897673";"wingshadoww Lam";"762";"379";"383";"761";"1";"662";"100";"80";"null";"null";"0.4973753280839895";"0.5026246719160105";"0.9986876640419947";"0.0013123359580052493";"0.868766404199475";"0.13123359580052493";"0.10498687664041995";"5"
"2254599";"Kiran215";"109";"69";"40";"60";"49";"59";"50";"13";"null";"null";"0.6330275229357798";"0.3669724770642202";"0.5504587155963303";"0.44954128440366975";"0.5412844036697247";"0.45871559633027525";"0.11926605504587157";"17"
"3790620";"Rohan Pradhan";"2";"0";"2";"1";"1";"2";"0";"0";"null";"null";"0.0";"1.0";"0.5";"0.5";"1.0";"0.0";"0.0";"1"
"4728687";"Drshashi";"1";"0";"1";"0";"1";"1";"0";"0";"null";"null";"0.0";"1.0";"0.0";"1.0";"1.0";"0.0";"0.0";"1"
"96041";"Hase";"11";"0";"11";"10";"1";"0";"11";"6";"null";"null";"0.0";"1.0";"0.9090909090909091";"0.09090909090909091";"0.0";"1.0";"0.5454545454545454";"1"
"91944";"MapHimalaya";"170";"2";"168";"168";"2";"115";"55";"7";"null";"null";"0.011764705882352941";"0.9882352941176471";"0.9882352941176471";"0.011764705882352941";"0.6764705882352942";"0.3235294117647059";"0.041176470588235294";"9"
"4212590";"Gaurav Thapa";"471";"328";"143";"347";"124";"297";"174";"34";"null";"null";"0.6963906581740976";"0.3036093418259023";"0.7367303609341825";"0.2632696390658174";"0.6305732484076433";"0.36942675159235666";"0.07218683651804671";"39"
"350005";"prabhasp";"356";"176";"180";"221";"135";"267";"89";"34";"null";"null";"0.4943820224719101";"0.5056179775280899";"0.6207865168539326";"0.3792134831460674";"0.75";"0.25";"0.09550561797752809";"33"
"2672408";"Bishesh Man Singh";"4";"3";"1";"3";"1";"2";"2";"1";"null";"null";"0.75";"0.25";"0.75";"0.25";"0.5";"0.5";"0.25";"2"
"653117";"prashantwosti";"36";"0";"36";"35";"1";"25";"11";"3";"null";"null";"0.0";"1.0";"0.9722222222222222";"0.027777777777777776";"0.6944444444444444";"0.3055555555555556";"0.08333333333333333";"2"
"186170";"KeumpSeattle";"734";"0";"734";"0";"734";"165";"569";"7";"null";"null";"0.0";"1.0";"0.0";"1.0";"0.22479564032697547";"0.7752043596730245";"0.009536784741144414";"4"
"1296171";"EOSfoto";"133";"132";"1";"132";"1";"133";"0";"0";"null";"null";"0.9924812030075187";"0.007518796992481203";"0.9924812030075187";"0.007518796992481203";"1.0";"0.0";"0.0";"1"
"255802";"cboothroyd";"4";"3";"1";"3";"1";"1";"3";"2";"null";"null";"0.75";"0.25";"0.75";"0.25";"0.25";"0.75";"0.5";"3"
"2885397";"GrethelR";"1";"0";"1";"0";"1";"0";"1";"0";"null";"null";"0.0";"1.0";"0.0";"1.0";"0.0";"1.0";"0.0";"1"
"2873104";"Apoorva Shenoy";"12";"11";"1";"11";"1";"12";"0";"0";"null";"null";"0.9166666666666666";"0.08333333333333333";"0.9166666666666666";"0.08333333333333333";"1.0";"0.0";"0.0";"2"
"292665";"Dr Kludge";"1";"0";"1";"0";"1";"0";"1";"0";"null";"null";"0.0";"1.0";"0.0";"1.0";"0.0";"1.0";"0.0";"1"
"603981";"Sam Inglis";"549";"164";"385";"548";"1";"544";"5";"5";"null";"null";"0.2987249544626594";"0.7012750455373407";"0.9981785063752276";"0.0018214936247723133";"0.9908925318761385";"0.009107468123861567";"0.009107468123861567";"5"
"75593";"Mika77";"414";"0";"414";"413";"1";"414";"0";"0";"null";"null";"0.0";"1.0";"0.9975845410628019";"0.0024154589371980675";"1.0";"0.0";"0.0";"3"
"4957953";"Mukhiya Amar";"1";"0";"1";"0";"1";"1";"0";"0";"null";"null";"0.0";"1.0";"0.0";"1.0";"1.0";"0.0";"0.0";"1"
"1230680";"Aditya Lepcha";"7";"6";"1";"6";"1";"7";"0";"0";"null";"null";"0.8571428571428571";"0.14285714285714285";"0.8571428571428571";"0.14285714285714285";"1.0";"0.0";"0.0";"3"
"2873184";"Vaskar_Nepal";"8";"7";"1";"7";"1";"7";"1";"1";"null";"null";"0.875";"0.125";"0.875";"0.125";"0.875";"0.125";"0.125";"2"
"145231";"woodpeck_repair";"7155";"195";"6960";"7153";"2";"0";"7155";"1836";"null";"null";"0.027253668763102725";"0.9727463312368972";"0.9997204751921733";"2.795248078266946E-4";"0.0";"1.0";"0.25660377358490566";"7"
"3893109";"Jay Shah420";"18";"10";"8";"12";"6";"17";"1";"0";"null";"null";"0.5555555555555556";"0.4444444444444444";"0.6666666666666666";"0.3333333333333333";"0.9444444444444444";"0.05555555555555555";"0.0";"3"
"2885475";"xtha";"6";"0";"6";"0";"6";"5";"1";"0";"null";"null";"0.0";"1.0";"0.0";"1.0";"0.8333333333333334";"0.16666666666666666";"0.0";"2"
"161619";"FvGordon";"30";"21";"9";"1";"29";"2";"28";"13";"null";"null";"0.7";"0.3";"0.03333333333333333";"0.9666666666666667";"0.06666666666666667";"0.9333333333333333";"0.43333333333333335";"10"
"2865022";"noemie_3";"22";"21";"1";"21";"1";"22";"0";"0";"null";"null";"0.9545454545454546";"0.045454545454545456";"0.9545454545454546";"0.045454545454545456";"1.0";"0.0";"0.0";"1"
"5974";"samlarsen1";"86";"0";"86";"85";"1";"79";"7";"0";"null";"null";"0.0";"1.0";"0.9883720930232558";"0.011627906976744186";"0.9186046511627907";"0.08139534883720931";"0.0";"4"
"2865020";"Gümüş Özdeş";"165";"0";"165";"164";"1";"165";"0";"0";"null";"null";"0.0";"1.0";"0.9939393939393939";"0.006060606060606061";"1.0";"0.0";"0.0";"3"
"206683";"ucesaca";"524";"386";"138";"386";"138";"520";"4";"4";"null";"null";"0.7366412213740458";"0.2633587786259542";"0.7366412213740458";"0.2633587786259542";"0.9923664122137404";"0.007633587786259542";"0.007633587786259542";"39"
"481116";"bigalxyz123";"115";"0";"115";"114";"1";"111";"4";"0";"null";"null";"0.0";"1.0";"0.991304347826087";"0.008695652173913044";"0.9652173913043478";"0.034782608695652174";"0.0";"1"
"3164012";"danidoedel";"43";"42";"1";"42";"1";"0";"43";"2";"null";"null";"0.9767441860465116";"0.023255813953488372";"0.9767441860465116";"0.023255813953488372";"0.0";"1.0";"0.046511627906976744";"1"
"3950432";"Anup Panthi";"1";"0";"1";"0";"1";"1";"0";"0";"null";"null";"0.0";"1.0";"0.0";"1.0";"1.0";"0.0";"0.0";"1"
"2877302";"LesleeHare";"600";"0";"600";"599";"1";"600";"0";"0";"null";"null";"0.0";"1.0";"0.9983333333333333";"0.0016666666666666668";"1.0";"0.0";"0.0";"9"
"2180929";"Sunil Kumar Maharjan";"70";"0";"70";"0";"70";"57";"13";"0";"null";"null";"0.0";"1.0";"0.0";"1.0";"0.8142857142857143";"0.18571428571428572";"0.0";"9"
"2504518";"jcant624";"30";"0";"30";"0";"30";"30";"0";"0";"null";"null";"0.0";"1.0";"0.0";"1.0";"1.0";"0.0";"0.0";"1"
"2873161";"Bijay Shrestha";"18";"0";"18";"17";"1";"3";"15";"0";"null";"null";"0.0";"1.0";"0.9444444444444444";"0.05555555555555555";"0.16666666666666666";"0.8333333333333334";"0.0";"2"
"3929949";"Bikashgyawali";"16";"5";"11";"3";"13";"12";"4";"0";"null";"null";"0.3125";"0.6875";"0.1875";"0.8125";"0.75";"0.25";"0.0";"14"
"2889540";"Viktoria_Kendall";"157";"156";"1";"156";"1";"157";"0";"0";"null";"null";"0.9936305732484076";"0.006369426751592357";"0.9936305732484076";"0.006369426751592357";"1.0";"0.0";"0.0";"6"
"2889541";"eschmitt";"16";"15";"1";"15";"1";"16";"0";"0";"null";"null";"0.9375";"0.0625";"0.9375";"0.0625";"1.0";"0.0";"0.0";"3"
"2889542";"2015rarens";"60";"59";"1";"59";"1";"53";"7";"0";"null";"null";"0.9833333333333333";"0.016666666666666666";"0.9833333333333333";"0.016666666666666666";"0.8833333333333333";"0.11666666666666667";"0.0";"15"
"2873152";"0109";"1";"0";"1";"0";"1";"0";"1";"0";"null";"null";"0.0";"1.0";"0.0";"1.0";"0.0";"1.0";"0.0";"1"
"2180941";"Newtonum";"15";"0";"15";"0";"15";"15";"0";"0";"null";"null";"0.0";"1.0";"0.0";"1.0";"1.0";"0.0";"0.0";"3"
"313192";"Ohr";"316";"233";"83";"315";"1";"301";"15";"0";"null";"null";"0.7373417721518988";"0.2626582278481013";"0.9968354430379747";"0.0031645569620253164";"0.9525316455696202";"0.04746835443037975";"0.0";"7"
"2889538";"2015cfelicia";"10";"9";"1";"9";"1";"10";"0";"0";"null";"null";"0.9";"0.1";"0.9";"0.1";"1.0";"0.0";"0.0";"2"
"2885443";"matshg";"698";"0";"698";"0";"698";"681";"17";"17";"null";"null";"0.0";"1.0";"0.0";"1.0";"0.9756446991404012";"0.024355300859598854";"0.024355300859598854";"4"
"2889564";"Bethany Joy";"142";"141";"1";"141";"1";"136";"6";"0";"null";"null";"0.9929577464788732";"0.007042253521126761";"0.9929577464788732";"0.007042253521126761";"0.9577464788732394";"0.04225352112676056";"0.0";"32"
"4986684";"pdlbhim";"1";"0";"1";"0";"1";"1";"0";"0";"null";"null";"0.0";"1.0";"0.0";"1.0";"1.0";"0.0";"0.0";"1"
"4998968";"Fabo prajapati";"2";"0";"2";"1";"1";"2";"0";"0";"null";"null";"0.0";"1.0";"0.5";"0.5";"1.0";"0.0";"0.0";"1"
"223093";"geow";"101";"0";"101";"100";"1";"31";"70";"8";"null";"null";"0.0";"1.0";"0.9900990099009901";"0.009900990099009901";"0.3069306930693069";"0.693069306930693";"0.07920792079207921";"2"
"2889556";"Cvander";"92";"91";"1";"91";"1";"92";"0";"0";"null";"null";"0.9891304347826086";"0.010869565217391304";"0.9891304347826086";"0.010869565217391304";"1.0";"0.0";"0.0";"21"
"4368186";"Bibek Katwal (katana08)";"2";"1";"1";"0";"2";"1";"1";"0";"null";"null";"0.5";"0.5";"0.0";"1.0";"0.5";"0.5";"0.0";"2"
"4929329";"Samoj Bhattarai";"5";"0";"5";"3";"2";"3";"2";"0";"null";"null";"0.0";"1.0";"0.6";"0.4";"0.6";"0.4";"0.0";"4"
"4278079";"Himalaya Airlines";"15";"14";"1";"14";"1";"8";"7";"6";"null";"null";"0.9333333333333333";"0.06666666666666667";"0.9333333333333333";"0.06666666666666667";"0.5333333333333333";"0.4666666666666667";"0.4";"5"
"2451367";"ctiml";"102";"0";"102";"101";"1";"100";"2";"0";"null";"null";"0.0";"1.0";"0.9901960784313726";"0.00980392156862745";"0.9803921568627451";"0.0196078431372549";"0.0";"5"
"2357162";"Anuj M Shrestha";"16";"14";"2";"15";"1";"10";"6";"0";"null";"null";"0.875";"0.125";"0.9375";"0.0625";"0.625";"0.375";"0.0";"2"
"4863940";"Diane Gasselin";"1";"0";"1";"0";"1";"1";"0";"0";"null";"null";"0.0";"1.0";"0.0";"1.0";"1.0";"0.0";"0.0";"1"
"1963922";"mauck";"6";"0";"6";"5";"1";"6";"0";"0";"null";"null";"0.0";"1.0";"0.8333333333333334";"0.16666666666666666";"1.0";"0.0";"0.0";"2"
"4364237";"Krishna K Shrestha";"4";"0";"4";"0";"4";"4";"0";"0";"null";"null";"0.0";"1.0";"0.0";"1.0";"1.0";"0.0";"0.0";"1"
"3995565";"Ashug Rai";"1";"0";"1";"0";"1";"1";"0";"0";"null";"null";"0.0";"1.0";"0.0";"1.0";"1.0";"0.0";"0.0";"1"
"1746818";"Kusala9";"155";"0";"155";"154";"1";"155";"0";"0";"null";"null";"0.0";"1.0";"0.9935483870967742";"0.0064516129032258064";"1.0";"0.0";"0.0";"1"
"2906038";"hananja";"1";"0";"1";"0";"1";"1";"0";"0";"null";"null";"0.0";"1.0";"0.0";"1.0";"1.0";"0.0";"0.0";"1"
"1443767";"Olyon";"3";"0";"3";"2";"1";"0";"3";"2";"null";"null";"0.0";"1.0";"0.6666666666666666";"0.3333333333333333";"0.0";"1.0";"0.6666666666666666";"2"
"1189808";"Rupendra";"3";"2";"1";"0";"3";"2";"1";"0";"null";"null";"0.6666666666666666";"0.3333333333333333";"0.0";"1.0";"0.6666666666666666";"0.3333333333333333";"0.0";"3"
"436132";"kaxtillo";"7";"6";"1";"0";"7";"7";"0";"0";"null";"null";"0.8571428571428571";"0.14285714285714285";"0.0";"1.0";"1.0";"0.0";"0.0";"1"
"817064";"三二一";"13";"10";"3";"11";"2";"8";"5";"0";"null";"null";"0.7692307692307693";"0.23076923076923078";"0.8461538461538461";"0.15384615384615385";"0.6153846153846154";"0.38461538461538464";"0.0";"7"
"2439042";"paparicio22";"136";"6";"130";"135";"1";"128";"8";"0";"null";"null";"0.04411764705882353";"0.9558823529411765";"0.9926470588235294";"0.007352941176470588";"0.9411764705882353";"0.058823529411764705";"0.0";"3"
"92075";"Art Penteur";"1";"0";"1";"0";"1";"0";"1";"0";"null";"null";"0.0";"1.0";"0.0";"1.0";"0.0";"1.0";"0.0";"1"
"2099083";"Inframaniac";"4";"3";"1";"3";"1";"4";"0";"0";"null";"null";"0.75";"0.25";"0.75";"0.25";"1.0";"0.0";"0.0";"1"
"2873223";"mvedma";"12";"11";"1";"11";"1";"12";"0";"0";"null";"null";"0.9166666666666666";"0.08333333333333333";"0.9166666666666666";"0.08333333333333333";"1.0";"0.0";"0.0";"3"
"1284029";"BhagirathBhatt";"1582";"769";"813";"1287";"295";"1070";"512";"153";"null";"null";"0.4860935524652339";"0.5139064475347661";"0.8135271807838179";"0.18647281921618206";"0.6763590391908976";"0.32364096080910243";"0.09671302149178256";"35"
"4863995";"Tandukar Sunil";"1";"0";"1";"0";"1";"1";"0";"0";"null";"null";"0.0";"1.0";"0.0";"1.0";"1.0";"0.0";"0.0";"1"
"2090925";"DermannD";"32";"0";"32";"31";"1";"30";"2";"0";"null";"null";"0.0";"1.0";"0.96875";"0.03125";"0.9375";"0.0625";"0.0";"2"
"5031929";"Sameekar Rai";"1";"0";"1";"0";"1";"0";"1";"0";"null";"null";"0.0";"1.0";"0.0";"1.0";"0.0";"1.0";"0.0";"1"
"4851711";"Avash";"26";"0";"26";"25";"1";"25";"1";"0";"null";"null";"0.0";"1.0";"0.9615384615384616";"0.038461538461538464";"0.9615384615384616";"0.038461538461538464";"0.0";"1"
"239546";"DF45";"564";"562";"2";"563";"1";"363";"201";"115";"null";"null";"0.9964539007092199";"0.0035460992907801418";"0.99822695035461";"0.0017730496453900709";"0.6436170212765957";"0.35638297872340424";"0.20390070921985815";"4"
"198585";"reportingsjr";"3021";"0";"3021";"2384";"637";"2683";"338";"60";"null";"null";"0.0";"1.0";"0.7891426679907315";"0.21085733200926846";"0.8881165177093677";"0.11188348229063225";"0.019860973187686197";"24"
"214969";"AndrewBuck";"63";"62";"1";"0";"63";"29";"34";"2";"null";"null";"0.9841269841269841";"0.015873015873015872";"0.0";"1.0";"0.4603174603174603";"0.5396825396825397";"0.031746031746031744";"1"
"1738656";"Jordi1024";"3";"0";"3";"0";"3";"3";"0";"0";"null";"null";"0.0";"1.0";"0.0";"1.0";"1.0";"0.0";"0.0";"3"
"2881431";"にゃー";"109";"76";"33";"108";"1";"109";"0";"0";"null";"null";"0.6972477064220184";"0.30275229357798167";"0.9908256880733946";"0.009174311926605505";"1.0";"0.0";"0.0";"10"
"3671941";"sugamt08";"15";"0";"15";"14";"1";"15";"0";"0";"null";"null";"0.0";"1.0";"0.9333333333333333";"0.06666666666666667";"1.0";"0.0";"0.0";"3"
"2881430";"senri";"305";"0";"305";"304";"1";"305";"0";"0";"null";"null";"0.0";"1.0";"0.9967213114754099";"0.003278688524590164";"1.0";"0.0";"0.0";"7"
"3868665";"Ra-B";"1";"0";"1";"0";"1";"1";"0";"0";"null";"null";"0.0";"1.0";"0.0";"1.0";"1.0";"0.0";"0.0";"1"
"3430384";"Binod Parajuli";"1";"0";"1";"0";"1";"1";"0";"0";"null";"null";"0.0";"1.0";"0.0";"1.0";"1.0";"0.0";"0.0";"1"
"2885609";"Blarneystone";"26";"0";"26";"25";"1";"10";"16";"4";"null";"null";"0.0";"1.0";"0.9615384615384616";"0.038461538461538464";"0.38461538461538464";"0.6153846153846154";"0.15384615384615385";"1"
"2639853";"Raghunath_Jha";"85";"59";"26";"59";"26";"53";"32";"7";"null";"null";"0.6941176470588235";"0.3058823529411765";"0.6941176470588235";"0.3058823529411765";"0.6235294117647059";"0.3764705882352941";"0.08235294117647059";"10"
"149451";"redrace";"899";"125";"774";"0";"899";"705";"194";"36";"null";"null";"0.13904338153503892";"0.8609566184649611";"0.0";"1.0";"0.7842046718576196";"0.21579532814238042";"0.04004449388209121";"8"
"2230248";"Gevenvieve";"1";"0";"1";"0";"1";"1";"0";"0";"null";"null";"0.0";"1.0";"0.0";"1.0";"1.0";"0.0";"0.0";"1"
"2803704";"Agatha Jetra";"164";"0";"164";"0";"164";"164";"0";"0";"null";"null";"0.0";"1.0";"0.0";"1.0";"1.0";"0.0";"0.0";"32"
"2787325";"Satya Narayan Suwal";"2723";"1782";"941";"2722";"1";"1629";"1094";"262";"null";"null";"0.654425266250459";"0.34557473374954095";"0.9996327579875137";"3.672420124862284E-4";"0.5982372383400661";"0.4017627616599339";"0.09621740727139184";"23"
"2439166";"Kshitiz324";"19";"0";"19";"0";"19";"13";"6";"0";"null";"null";"0.0";"1.0";"0.0";"1.0";"0.6842105263157895";"0.3157894736842105";"0.0";"1"
"1210319";"hannis";"39";"0";"39";"38";"1";"32";"7";"0";"null";"null";"0.0";"1.0";"0.9743589743589743";"0.02564102564102564";"0.8205128205128205";"0.1794871794871795";"0.0";"1"
"3291117";"Rajendra Dongol";"658";"548";"110";"624";"34";"476";"182";"38";"null";"null";"0.8328267477203647";"0.16717325227963525";"0.9483282674772037";"0.05167173252279635";"0.723404255319149";"0.2765957446808511";"0.057750759878419454";"19"
"690133";"tquadrat";"284";"0";"284";"283";"1";"220";"64";"24";"null";"null";"0.0";"1.0";"0.9964788732394366";"0.0035211267605633804";"0.7746478873239436";"0.22535211267605634";"0.08450704225352113";"2"
"4728744";"Jonnyjkynm";"1";"0";"1";"0";"1";"1";"0";"0";"null";"null";"0.0";"1.0";"0.0";"1.0";"1.0";"0.0";"0.0";"1"
"202726";"whb";"156";"155";"1";"155";"1";"111";"45";"4";"null";"null";"0.9935897435897436";"0.00641025641025641";"0.9935897435897436";"0.00641025641025641";"0.7115384615384616";"0.28846153846153844";"0.02564102564102564";"2"
"3491792";"Prahlad Vishwakarma";"7";"6";"1";"6";"1";"7";"0";"0";"null";"null";"0.8571428571428571";"0.14285714285714285";"0.8571428571428571";"0.14285714285714285";"1.0";"0.0";"0.0";"1"
"2344901";"silvan315";"50";"0";"50";"49";"1";"50";"0";"0";"null";"null";"0.0";"1.0";"0.98";"0.02";"1.0";"0.0";"0.0";"2"
"1198074";"DoubleA";"14";"0";"14";"0";"14";"0";"14";"0";"null";"null";"0.0";"1.0";"0.0";"1.0";"0.0";"1.0";"0.0";"2"
"2877383";"GiddyDude";"3";"0";"3";"2";"1";"3";"0";"0";"null";"null";"0.0";"1.0";"0.6666666666666666";"0.3333333333333333";"1.0";"0.0";"0.0";"1"
"2107341";"yoneshin";"535";"0";"535";"534";"1";"531";"4";"4";"null";"null";"0.0";"1.0";"0.9981308411214953";"0.001869158878504673";"0.9925233644859813";"0.007476635514018692";"0.007476635514018692";"12"
"3409882";"arvi1222";"2";"1";"1";"1";"1";"2";"0";"0";"null";"null";"0.5";"0.5";"0.5";"0.5";"1.0";"0.0";"0.0";"1"
"2107343";"marin_528";"434";"252";"182";"316";"118";"434";"0";"0";"null";"null";"0.5806451612903226";"0.41935483870967744";"0.728110599078341";"0.271889400921659";"1.0";"0.0";"0.0";"100"
"1902578";"mingo23";"69";"0";"69";"0";"69";"35";"34";"16";"null";"null";"0.0";"1.0";"0.0";"1.0";"0.5072463768115942";"0.4927536231884058";"0.2318840579710145";"1"
"2750425";"Subhas";"3";"2";"1";"2";"1";"3";"0";"0";"null";"null";"0.6666666666666666";"0.3333333333333333";"0.6666666666666666";"0.3333333333333333";"1.0";"0.0";"0.0";"1"
"1783785";"R0bst3r";"1";"0";"1";"0";"1";"0";"1";"0";"null";"null";"0.0";"1.0";"0.0";"1.0";"0.0";"1.0";"0.0";"1"
"4835258";"Ravin Singh Raut";"1";"0";"1";"0";"1";"1";"0";"0";"null";"null";"0.0";"1.0";"0.0";"1.0";"1.0";"0.0";"0.0";"1"
"2103252";"Smilez";"398";"0";"398";"397";"1";"379";"19";"2";"null";"null";"0.0";"1.0";"0.9974874371859297";"0.002512562814070352";"0.9522613065326633";"0.04773869346733668";"0.005025125628140704";"2"
"2897877";"RyanLloyd";"113";"0";"113";"112";"1";"84";"29";"23";"null";"null";"0.0";"1.0";"0.9911504424778761";"0.008849557522123894";"0.7433628318584071";"0.25663716814159293";"0.20353982300884957";"4"
"2660305";"tleighmedy";"180";"179";"1";"0";"180";"180";"0";"0";"null";"null";"0.9944444444444445";"0.005555555555555556";"0.0";"1.0";"1.0";"0.0";"0.0";"4"
"2107354";"kanakofunyu";"157";"36";"121";"0";"157";"157";"0";"0";"null";"null";"0.22929936305732485";"0.7707006369426752";"0.0";"1.0";"1.0";"0.0";"0.0";"4"
"2881488";"Prague";"198";"0";"198";"197";"1";"190";"8";"8";"null";"null";"0.0";"1.0";"0.9949494949494949";"0.005050505050505051";"0.9595959595959596";"0.04040404040404041";"0.04040404040404041";"7"
"2881495";"MattPrice";"7";"0";"7";"6";"1";"7";"0";"0";"null";"null";"0.0";"1.0";"0.8571428571428571";"0.14285714285714285";"1.0";"0.0";"0.0";"1"
"2750423";"Abhushan Timsina";"11";"10";"1";"10";"1";"10";"1";"0";"null";"null";"0.9090909090909091";"0.09090909090909091";"0.9090909090909091";"0.09090909090909091";"0.9090909090909091";"0.09090909090909091";"0.0";"2"
"2033694";"Kamilsniltiak";"240";"0";"240";"191";"49";"238";"2";"1";"null";"null";"0.0";"1.0";"0.7958333333333333";"0.20416666666666666";"0.9916666666666667";"0.008333333333333333";"0.004166666666666667";"42"
"2857001";"akaldas";"5";"0";"5";"0";"5";"5";"0";"0";"null";"null";"0.0";"1.0";"0.0";"1.0";"1.0";"0.0";"0.0";"2"
"2328608";"praj1991";"20";"10";"10";"19";"1";"18";"2";"1";"null";"null";"0.5";"0.5";"0.95";"0.05";"0.9";"0.1";"0.05";"5"
"4241479";"Purna Adhikari";"7";"0";"7";"6";"1";"6";"1";"0";"null";"null";"0.0";"1.0";"0.8571428571428571";"0.14285714285714285";"0.8571428571428571";"0.14285714285714285";"0.0";"5"
"178186";"mdk";"896";"1";"895";"894";"2";"388";"508";"226";"null";"null";"0.0011160714285714285";"0.9988839285714286";"0.9977678571428571";"0.002232142857142857";"0.4330357142857143";"0.5669642857142857";"0.25223214285714285";"10"
"5036101";"Umesh Khakurel";"2";"1";"1";"1";"1";"1";"1";"0";"null";"null";"0.5";"0.5";"0.5";"0.5";"0.5";"0.5";"0.0";"2"
"2795555";"कृषक र प्रविधि";"4";"0";"4";"3";"1";"0";"4";"2";"null";"null";"0.0";"1.0";"0.75";"0.25";"0.0";"1.0";"0.5";"1"
"4995141";"Dhital Babu";"1";"0";"1";"0";"1";"1";"0";"0";"null";"null";"0.0";"1.0";"0.0";"1.0";"1.0";"0.0";"0.0";"1"
"3356729";"kewal shrestha";"19";"0";"19";"18";"1";"10";"9";"5";"null";"null";"0.0";"1.0";"0.9473684210526315";"0.05263157894736842";"0.5263157894736842";"0.47368421052631576";"0.2631578947368421";"4"
"2328623";"aayushma";"99";"58";"41";"40";"59";"64";"35";"5";"null";"null";"0.5858585858585859";"0.41414141414141414";"0.40404040404040403";"0.5959595959595959";"0.6464646464646465";"0.35353535353535354";"0.050505050505050504";"7"
"104461";"brunosan";"3";"0";"3";"2";"1";"3";"0";"0";"null";"null";"0.0";"1.0";"0.6666666666666666";"0.3333333333333333";"1.0";"0.0";"0.0";"1"
"129039";"funkbag";"2174";"2173";"1";"0";"2174";"2057";"117";"6";"null";"null";"0.999540018399264";"4.5998160073597056E-4";"0.0";"1.0";"0.9461821527138914";"0.053817847286108556";"0.0027598896044158236";"41"
"706587";"Семён Семёнов";"948";"0";"948";"947";"1";"770";"178";"74";"null";"null";"0.0";"1.0";"0.9989451476793249";"0.0010548523206751054";"0.8122362869198312";"0.1877637130801688";"0.07805907172995781";"1"
"2328624";"Neekesh";"10";"0";"10";"9";"1";"10";"0";"0";"null";"null";"0.0";"1.0";"0.9";"0.1";"1.0";"0.0";"0.0";"2"
"2328630";"sujan prajapati";"42";"24";"18";"12";"30";"36";"6";"1";"null";"null";"0.5714285714285714";"0.42857142857142855";"0.2857142857142857";"0.7142857142857143";"0.8571428571428571";"0.14285714285714285";"0.023809523809523808";"7"
"2328629";"Rohini Thapa";"45";"43";"2";"1";"44";"44";"1";"0";"null";"null";"0.9555555555555556";"0.044444444444444446";"0.022222222222222223";"0.9777777777777777";"0.9777777777777777";"0.022222222222222223";"0.0";"4"
"4847711";"Lalit Heritage Home";"1";"0";"1";"0";"1";"1";"0";"0";"null";"null";"0.0";"1.0";"0.0";"1.0";"1.0";"0.0";"0.0";"1"
"2328628";"Sushmita";"114";"14";"100";"113";"1";"65";"49";"14";"null";"null";"0.12280701754385964";"0.8771929824561403";"0.9912280701754386";"0.008771929824561403";"0.5701754385964912";"0.4298245614035088";"0.12280701754385964";"5"
"2582591";"Uden";"21";"20";"1";"0";"21";"17";"4";"4";"null";"null";"0.9523809523809523";"0.047619047619047616";"0.0";"1.0";"0.8095238095238095";"0.19047619047619047";"0.19047619047619047";"7"
"2926644";"Faith Helps";"240";"239";"1";"239";"1";"240";"0";"0";"null";"null";"0.9958333333333333";"0.004166666666666667";"0.9958333333333333";"0.004166666666666667";"1.0";"0.0";"0.0";"2"
"4663390";"Nepali Kancha";"2";"1";"1";"1";"1";"2";"0";"0";"null";"null";"0.5";"0.5";"0.5";"0.5";"1.0";"0.0";"0.0";"2"
"2328633";"ranzan";"85";"0";"85";"84";"1";"50";"35";"30";"null";"null";"0.0";"1.0";"0.9882352941176471";"0.011764705882352941";"0.5882352941176471";"0.4117647058823529";"0.35294117647058826";"3"
"2897975";"jcrosby";"12";"0";"12";"11";"1";"12";"0";"0";"null";"null";"0.0";"1.0";"0.9166666666666666";"0.08333333333333333";"1.0";"0.0";"0.0";"1"
"2328632";"rekesh";"12";"0";"12";"11";"1";"9";"3";"0";"null";"null";"0.0";"1.0";"0.9166666666666666";"0.08333333333333333";"0.75";"0.25";"0.0";"1"
"2328637";"SatishTmg";"32";"0";"32";"31";"1";"26";"6";"4";"null";"null";"0.0";"1.0";"0.96875";"0.03125";"0.8125";"0.1875";"0.125";"6"
"2631735";"Jerome____";"2453";"744";"1709";"2452";"1";"2431";"22";"18";"null";"null";"0.30330207908683243";"0.6966979209131675";"0.9995923359152059";"4.0766408479412964E-4";"0.9910313901345291";"0.008968609865470852";"0.007337953526294333";"43"
"2328636";"Raju350";"56";"0";"56";"55";"1";"29";"27";"5";"null";"null";"0.0";"1.0";"0.9821428571428571";"0.017857142857142856";"0.5178571428571429";"0.48214285714285715";"0.08928571428571429";"4"
"2877448";"TurriffHousewife";"9";"0";"9";"8";"1";"9";"0";"0";"null";"null";"0.0";"1.0";"0.8888888888888888";"0.1111111111111111";"1.0";"0.0";"0.0";"2"
"4249701";"Portgas Ace";"1";"0";"1";"0";"1";"1";"0";"0";"null";"null";"0.0";"1.0";"0.0";"1.0";"1.0";"0.0";"0.0";"1"
"3917852";"Stha Yoroj";"1";"0";"1";"0";"1";"1";"0";"0";"null";"null";"0.0";"1.0";"0.0";"1.0";"1.0";"0.0";"0.0";"1"
"2877443";"laurabr";"124";"0";"124";"123";"1";"116";"8";"4";"null";"null";"0.0";"1.0";"0.9919354838709677";"0.008064516129032258";"0.9354838709677419";"0.06451612903225806";"0.03225806451612903";"1"
"4917347";"Azizz Nepal";"1";"0";"1";"0";"1";"1";"0";"0";"null";"null";"0.0";"1.0";"0.0";"1.0";"1.0";"0.0";"0.0";"1"
"4474991";"Nirjhar";"1";"0";"1";"0";"1";"1";"0";"0";"null";"null";"0.0";"1.0";"0.0";"1.0";"1.0";"0.0";"0.0";"1"
"2328595";"pranu";"17";"0";"17";"16";"1";"8";"9";"3";"null";"null";"0.0";"1.0";"0.9411764705882353";"0.058823529411764705";"0.47058823529411764";"0.5294117647058824";"0.17647058823529413";"2"
"2328592";"nirisht";"15";"0";"15";"14";"1";"12";"3";"1";"null";"null";"0.0";"1.0";"0.9333333333333333";"0.06666666666666667";"0.8";"0.2";"0.06666666666666667";"3"
"4860031";"SagunP";"20";"19";"1";"19";"1";"6";"14";"14";"null";"null";"0.95";"0.05";"0.95";"0.05";"0.3";"0.7";"0.7";"4"
"2328598";"cyonz";"110";"76";"34";"33";"77";"72";"38";"12";"null";"null";"0.6909090909090909";"0.3090909090909091";"0.3";"0.7";"0.6545454545454545";"0.34545454545454546";"0.10909090909090909";"2"
"4331639";"simpl3punk";"1";"0";"1";"0";"1";"1";"0";"0";"null";"null";"0.0";"1.0";"0.0";"1.0";"1.0";"0.0";"0.0";"1"
"1714220";"luschi";"2";"0";"2";"1";"1";"1";"1";"1";"null";"null";"0.0";"1.0";"0.5";"0.5";"0.5";"0.5";"0.5";"2"
"2328596";"PrayagKhanal";"42";"0";"42";"41";"1";"37";"5";"0";"null";"null";"0.0";"1.0";"0.9761904761904762";"0.023809523809523808";"0.8809523809523809";"0.11904761904761904";"0.0";"3"
"4397179";"shubham4564";"1";"0";"1";"0";"1";"1";"0";"0";"null";"null";"0.0";"1.0";"0.0";"1.0";"1.0";"0.0";"0.0";"1"
"2328602";"niroj77";"103";"0";"103";"102";"1";"73";"30";"24";"null";"null";"0.0";"1.0";"0.9902912621359223";"0.009708737864077669";"0.7087378640776699";"0.2912621359223301";"0.23300970873786409";"1"
"2328601";"prakash1539";"2";"0";"2";"1";"1";"1";"1";"0";"null";"null";"0.0";"1.0";"0.5";"0.5";"0.5";"0.5";"0.0";"2"
"2328607";"richa15";"26";"25";"1";"0";"26";"25";"1";"0";"null";"null";"0.9615384615384616";"0.038461538461538464";"0.0";"1.0";"0.9615384615384616";"0.038461538461538464";"0.0";"1"
"2889746";"Casie";"29";"0";"29";"28";"1";"0";"29";"0";"null";"null";"0.0";"1.0";"0.9655172413793104";"0.034482758620689655";"0.0";"1.0";"0.0";"5"
"3844219";"Bpariyar";"5";"0";"5";"4";"1";"4";"1";"0";"null";"null";"0.0";"1.0";"0.8";"0.2";"0.8";"0.2";"0.0";"4"
"2308193";"Bijaya Maharjan";"121";"0";"121";"0";"121";"120";"1";"0";"null";"null";"0.0";"1.0";"0.0";"1.0";"0.9917355371900827";"0.008264462809917356";"0.0";"1"
"1960024";"BuganiniQ";"2";"1";"1";"1";"1";"0";"2";"0";"null";"null";"0.5";"0.5";"0.5";"0.5";"0.0";"1.0";"0.0";"2"
"596047";"Rps333";"284";"283";"1";"0";"284";"283";"1";"0";"null";"null";"0.9964788732394366";"0.0035211267605633804";"0.0";"1.0";"0.9964788732394366";"0.0035211267605633804";"0.0";"1"
"2209894";"Spanholz";"1";"0";"1";"0";"1";"0";"1";"0";"null";"null";"0.0";"1.0";"0.0";"1.0";"0.0";"1.0";"0.0";"1"
"4413461";"Ashesh Poudel";"1";"0";"1";"0";"1";"1";"0";"0";"null";"null";"0.0";"1.0";"0.0";"1.0";"1.0";"0.0";"0.0";"1"
"3844195";"Rajman Shrestha";"16";"0";"16";"15";"1";"16";"0";"0";"null";"null";"0.0";"1.0";"0.9375";"0.0625";"1.0";"0.0";"0.0";"2"
"3844196";"Ravi Thapa Magar";"10";"7";"3";"9";"1";"2";"8";"8";"null";"null";"0.7";"0.3";"0.9";"0.1";"0.2";"0.8";"0.8";"2"
"4847638";"रमेश ग्वाछा";"1";"0";"1";"0";"1";"1";"0";"0";"null";"null";"0.0";"1.0";"0.0";"1.0";"1.0";"0.0";"0.0";"1"
"3844197";"lok shastra";"5";"0";"5";"4";"1";"5";"0";"0";"null";"null";"0.0";"1.0";"0.8";"0.2";"1.0";"0.0";"0.0";"1"
"1939581";"Jomals";"101";"0";"101";"100";"1";"101";"0";"0";"null";"null";"0.0";"1.0";"0.9900990099009901";"0.009900990099009901";"1.0";"0.0";"0.0";"18"
"3844186";"Bijay Karki";"3";"0";"3";"2";"1";"3";"0";"0";"null";"null";"0.0";"1.0";"0.6666666666666666";"0.3333333333333333";"1.0";"0.0";"0.0";"1"
"4155486";"Bishnu Subedi";"1";"0";"1";"0";"1";"1";"0";"0";"null";"null";"0.0";"1.0";"0.0";"1.0";"1.0";"0.0";"0.0";"1"
"4286496";"Sakar Bhattarai";"1";"0";"1";"0";"1";"1";"0";"0";"null";"null";"0.0";"1.0";"0.0";"1.0";"1.0";"0.0";"0.0";"1"
"3844187";"keshari";"4";"0";"4";"3";"1";"4";"0";"0";"null";"null";"0.0";"1.0";"0.75";"0.25";"1.0";"0.0";"0.0";"1"
"2885709";"Katiemhw";"2";"0";"2";"0";"2";"2";"0";"0";"null";"null";"0.0";"1.0";"0.0";"1.0";"1.0";"0.0";"0.0";"1"
"2443335";"Treflou";"264";"0";"264";"263";"1";"255";"9";"0";"null";"null";"0.0";"1.0";"0.9962121212121212";"0.003787878787878788";"0.9659090909090909";"0.03409090909090909";"0.0";"1"
"3844189";"Navindra";"2";"0";"2";"1";"1";"1";"1";"0";"null";"null";"0.0";"1.0";"0.5";"0.5";"0.5";"0.5";"0.0";"2"
"4597804";"Byanjankartuyulal Tuyu";"1";"0";"1";"0";"1";"1";"0";"0";"null";"null";"0.0";"1.0";"0.0";"1.0";"1.0";"0.0";"0.0";"1"
"2254920";"ZeboStoneleigh";"5";"0";"5";"4";"1";"4";"1";"0";"null";"null";"0.0";"1.0";"0.8";"0.2";"0.8";"0.2";"0.0";"1"
"2013300";"mana47";"11";"10";"1";"0";"11";"6";"5";"0";"null";"null";"0.9090909090909091";"0.09090909090909091";"0.0";"1.0";"0.5454545454545454";"0.45454545454545453";"0.0";"2"
"1239166";"Nikesh Balami";"908";"365";"543";"492";"416";"697";"211";"154";"null";"null";"0.40198237885462557";"0.5980176211453745";"0.5418502202643172";"0.4581497797356828";"0.7676211453744494";"0.23237885462555066";"0.1696035242290749";"89"
"383081";"charlesf";"1";"0";"1";"0";"1";"1";"0";"0";"null";"null";"0.0";"1.0";"0.0";"1.0";"1.0";"0.0";"0.0";"1"
"4753445";"Tribelhorn Pascal";"1";"0";"1";"0";"1";"0";"1";"0";"null";"null";"0.0";"1.0";"0.0";"1.0";"0.0";"1.0";"0.0";"1"
"3962957";"Pradip Khanal";"2";"0";"2";"0";"2";"2";"0";"0";"null";"null";"0.0";"1.0";"0.0";"1.0";"1.0";"0.0";"0.0";"2"
"92274";"adjuva";"3";"1";"2";"0";"3";"0";"3";"0";"null";"null";"0.3333333333333333";"0.6666666666666666";"0.0";"1.0";"0.0";"1.0";"0.0";"3"
"2512978";"Bhawana Dahal";"1";"0";"1";"0";"1";"0";"1";"0";"null";"null";"0.0";"1.0";"0.0";"1.0";"0.0";"1.0";"0.0";"1"
"2877525";"nshrestha";"399";"0";"399";"398";"1";"399";"0";"0";"null";"null";"0.0";"1.0";"0.9974937343358395";"0.002506265664160401";"1.0";"0.0";"0.0";"3"
"141442";"CycleStreets";"1";"0";"1";"0";"1";"1";"0";"0";"null";"null";"0.0";"1.0";"0.0";"1.0";"1.0";"0.0";"0.0";"1"
"2861226";"PAN_tw";"13";"12";"1";"0";"13";"13";"0";"0";"null";"null";"0.9230769230769231";"0.07692307692307693";"0.0";"1.0";"1.0";"0.0";"0.0";"1"
"3049647";"Runzeed Singh Thapa";"1";"0";"1";"0";"1";"1";"0";"0";"null";"null";"0.0";"1.0";"0.0";"1.0";"1.0";"0.0";"0.0";"1"
"129157";"Scare!";"63";"0";"63";"62";"1";"50";"13";"7";"null";"null";"0.0";"1.0";"0.9841269841269841";"0.015873015873015872";"0.7936507936507936";"0.20634920634920634";"0.1111111111111111";"6"
"4151483";"Carlota Burrel Mas";"1";"0";"1";"0";"1";"1";"0";"0";"null";"null";"0.0";"1.0";"0.0";"1.0";"1.0";"0.0";"0.0";"1"
"2115749";"srividya_c";"14";"0";"14";"13";"1";"5";"9";"0";"null";"null";"0.0";"1.0";"0.9285714285714286";"0.07142857142857142";"0.35714285714285715";"0.6428571428571429";"0.0";"6"
"2246826";"vichada";"2573";"0";"2573";"2572";"1";"2552";"21";"12";"null";"null";"0.0";"1.0";"0.9996113486202876";"3.88651379712398E-4";"0.9918383210260396";"0.008161678973960357";"0.004663816556548776";"9"
"2861219";"nakazumi";"74";"69";"5";"73";"1";"62";"12";"12";"null";"null";"0.9324324324324325";"0.06756756756756757";"0.9864864864864865";"0.013513513513513514";"0.8378378378378378";"0.16216216216216217";"0.16216216216216217";"15"
"4847809";"Rajeev Dhungel";"1";"0";"1";"0";"1";"0";"1";"0";"null";"null";"0.0";"1.0";"0.0";"1.0";"0.0";"1.0";"0.0";"1"
"2513066";"ari3104";"26";"0";"26";"0";"26";"26";"0";"0";"null";"null";"0.0";"1.0";"0.0";"1.0";"1.0";"0.0";"0.0";"4"
"424073";"gregg33";"88";"87";"1";"87";"1";"88";"0";"0";"null";"null";"0.9886363636363636";"0.011363636363636364";"0.9886363636363636";"0.011363636363636364";"1.0";"0.0";"0.0";"1"
"2951357";"Li Qu";"1";"0";"1";"0";"1";"1";"0";"0";"null";"null";"0.0";"1.0";"0.0";"1.0";"1.0";"0.0";"0.0";"1"
"1337478";"Ekki_df4or";"524";"0";"524";"523";"1";"524";"0";"0";"null";"null";"0.0";"1.0";"0.9980916030534351";"0.0019083969465648854";"1.0";"0.0";"0.0";"3"
"3618977";"illya2400";"2";"0";"2";"1";"1";"2";"0";"0";"null";"null";"0.0";"1.0";"0.5";"0.5";"1.0";"0.0";"0.0";"1"
"1247365";"ukie_girl";"80";"3";"77";"79";"1";"80";"0";"0";"null";"null";"0.0375";"0.9625";"0.9875";"0.0125";"1.0";"0.0";"0.0";"2"
"3618976";"ProjectThis";"2";"0";"2";"1";"1";"0";"2";"0";"null";"null";"0.0";"1.0";"0.5";"0.5";"0.0";"1.0";"0.0";"1"
"3106997";"daraasu";"13";"12";"1";"12";"1";"1";"12";"12";"null";"null";"0.9230769230769231";"0.07692307692307693";"0.9230769230769231";"0.07692307692307693";"0.07692307692307693";"0.9230769230769231";"0.9230769230769231";"3"
"2873525";"hammonddd";"67";"0";"67";"0";"67";"67";"0";"0";"null";"null";"0.0";"1.0";"0.0";"1.0";"1.0";"0.0";"0.0";"1"
"3844251";"Bibhu2065";"5";"3";"2";"4";"1";"1";"4";"4";"null";"null";"0.6";"0.4";"0.8";"0.2";"0.2";"0.8";"0.8";"2"
"4839656";"NextUp13";"1";"0";"1";"0";"1";"1";"0";"0";"null";"null";"0.0";"1.0";"0.0";"1.0";"1.0";"0.0";"0.0";"1"
"2750602";"maxmorch";"5";"4";"1";"4";"1";"5";"0";"0";"null";"null";"0.8";"0.2";"0.8";"0.2";"1.0";"0.0";"0.0";"5"
"2881666";"Shaashi Ahlawat";"32";"31";"1";"31";"1";"32";"0";"0";"null";"null";"0.96875";"0.03125";"0.96875";"0.03125";"1.0";"0.0";"0.0";"2"
"2553996";"gbrauen";"639";"638";"1";"638";"1";"626";"13";"0";"null";"null";"0.9984350547730829";"0.001564945226917058";"0.9984350547730829";"0.001564945226917058";"0.9796557120500783";"0.02034428794992175";"0.0";"7"
"2644101";"Chetan_Gowda";"1372";"1371";"1";"1371";"1";"1342";"30";"13";"null";"null";"0.999271137026239";"7.288629737609329E-4";"0.999271137026239";"7.288629737609329E-4";"0.978134110787172";"0.021865889212827987";"0.009475218658892129";"4"
"4761830";"Pnasa Pnasa";"5";"1";"4";"2";"3";"3";"2";"0";"null";"null";"0.2";"0.8";"0.4";"0.6";"0.6";"0.4";"0.0";"4"
"2750598";"moonway";"11";"9";"2";"9";"2";"11";"0";"0";"null";"null";"0.8181818181818182";"0.18181818181818182";"0.8181818181818182";"0.18181818181818182";"1.0";"0.0";"0.0";"3"
"2898079";"Eternite Ananta";"12";"0";"12";"11";"1";"12";"0";"0";"null";"null";"0.0";"1.0";"0.9166666666666666";"0.08333333333333333";"1.0";"0.0";"0.0";"2"
"4528371";"Bidhan Shrestha";"1";"0";"1";"0";"1";"1";"0";"0";"null";"null";"0.0";"1.0";"0.0";"1.0";"1.0";"0.0";"0.0";"1"
"4921587";"AccessTheAsia";"6";"4";"2";"0";"6";"1";"5";"1";"null";"null";"0.6666666666666666";"0.3333333333333333";"0.0";"1.0";"0.16666666666666666";"0.8333333333333334";"0.16666666666666666";"3"
"2877587";"Rashika Joshi";"1";"0";"1";"0";"1";"1";"0";"0";"null";"null";"0.0";"1.0";"0.0";"1.0";"1.0";"0.0";"0.0";"1"
"2467997";"Khym";"52";"0";"52";"0";"52";"52";"0";"0";"null";"null";"0.0";"1.0";"0.0";"1.0";"1.0";"0.0";"0.0";"4"
"2877591";"tmcd123";"1";"0";"1";"0";"1";"0";"1";"1";"null";"null";"0.0";"1.0";"0.0";"1.0";"0.0";"1.0";"1.0";"1"
"497849";"pyram";"67";"6";"61";"60";"7";"6";"61";"29";"null";"null";"0.08955223880597014";"0.9104477611940298";"0.8955223880597015";"0.1044776119402985";"0.08955223880597014";"0.9104477611940298";"0.43283582089552236";"2"
"2627816";"Roar N N";"465";"0";"465";"464";"1";"460";"5";"2";"null";"null";"0.0";"1.0";"0.9978494623655914";"0.002150537634408602";"0.989247311827957";"0.010752688172043012";"0.004301075268817204";"1"
"2873576";"ppokharel";"37";"36";"1";"36";"1";"14";"23";"10";"null";"null";"0.972972972972973";"0.02702702702702703";"0.972972972972973";"0.02702702702702703";"0.3783783783783784";"0.6216216216216216";"0.2702702702702703";"1"
"3619060";"Hector Vector";"21";"19";"2";"20";"1";"1";"20";"19";"null";"null";"0.9047619047619048";"0.09523809523809523";"0.9523809523809523";"0.047619047619047616";"0.047619047619047616";"0.9523809523809523";"0.9047619047619048";"3"
"1947864";"rosangela03";"622";"0";"622";"621";"1";"613";"9";"2";"null";"null";"0.0";"1.0";"0.9983922829581994";"0.001607717041800643";"0.9855305466237942";"0.014469453376205787";"0.003215434083601286";"18"
"1288406";"liviadegrossi";"18";"0";"18";"17";"1";"18";"0";"0";"null";"null";"0.0";"1.0";"0.9444444444444444";"0.05555555555555555";"1.0";"0.0";"0.0";"4"
"4466818";"manishOSM";"55";"0";"55";"54";"1";"55";"0";"0";"null";"null";"0.0";"1.0";"0.9818181818181818";"0.01818181818181818";"1.0";"0.0";"0.0";"1"
"2689262";"Shankar Koirala";"19";"18";"1";"0";"19";"19";"0";"0";"null";"null";"0.9473684210526315";"0.05263157894736842";"0.0";"1.0";"1.0";"0.0";"0.0";"6"
"4716672";"riwaj neupane";"1";"0";"1";"0";"1";"1";"0";"0";"null";"null";"0.0";"1.0";"0.0";"1.0";"1.0";"0.0";"0.0";"1"
"4176120";"Rajendra Shrestha";"1";"0";"1";"0";"1";"1";"0";"0";"null";"null";"0.0";"1.0";"0.0";"1.0";"1.0";"0.0";"0.0";"1"
"2873570";"Snig Bhaumik";"16";"2";"14";"15";"1";"12";"4";"0";"null";"null";"0.125";"0.875";"0.9375";"0.0625";"0.75";"0.25";"0.0";"8"
"2877665";"Ilzeav";"448";"213";"235";"447";"1";"448";"0";"0";"null";"null";"0.47544642857142855";"0.5245535714285714";"0.9977678571428571";"0.002232142857142857";"1.0";"0.0";"0.0";"5"
"2316520";"Shstone82";"71";"0";"71";"70";"1";"71";"0";"0";"null";"null";"0.0";"1.0";"0.9859154929577465";"0.014084507042253521";"1.0";"0.0";"0.0";"5"
"3660024";"Megan Oropeza";"17";"0";"17";"16";"1";"14";"3";"0";"null";"null";"0.0";"1.0";"0.9411764705882353";"0.058823529411764705";"0.8235294117647058";"0.17647058823529413";"0.0";"1"
"4466836";"reuspect";"7";"0";"7";"6";"1";"3";"4";"2";"null";"null";"0.0";"1.0";"0.8571428571428571";"0.14285714285714285";"0.42857142857142855";"0.5714285714285714";"0.2857142857142857";"3"
"4839576";"In Fashion";"2";"1";"1";"0";"2";"1";"1";"0";"null";"null";"0.5";"0.5";"0.0";"1.0";"0.5";"0.5";"0.0";"2"
"3999983";"niranjanshk";"3";"2";"1";"2";"1";"3";"0";"0";"null";"null";"0.6666666666666666";"0.3333333333333333";"0.6666666666666666";"0.3333333333333333";"1.0";"0.0";"0.0";"1"
"2877695";"Blix05";"4";"0";"4";"3";"1";"3";"1";"0";"null";"null";"0.0";"1.0";"0.75";"0.25";"0.75";"0.25";"0.0";"1"
"223444";"OMNIBUS";"9";"1";"8";"2";"7";"9";"0";"0";"null";"null";"0.1111111111111111";"0.8888888888888888";"0.2222222222222222";"0.7777777777777778";"1.0";"0.0";"0.0";"3"
"211162";"skorbut";"81";"0";"81";"80";"1";"4";"77";"41";"null";"null";"0.0";"1.0";"0.9876543209876543";"0.012345679012345678";"0.04938271604938271";"0.9506172839506173";"0.5061728395061729";"1"
"2873586";"Laura Ko";"46";"45";"1";"45";"1";"46";"0";"0";"null";"null";"0.9782608695652174";"0.021739130434782608";"0.9782608695652174";"0.021739130434782608";"1.0";"0.0";"0.0";"2"
"3844320";"Krishna Raj Aryal";"2";"0";"2";"1";"1";"2";"0";"0";"null";"null";"0.0";"1.0";"0.5";"0.5";"1.0";"0.0";"0.0";"1"
"2480327";"etajin";"2";"1";"1";"0";"2";"0";"2";"0";"null";"null";"0.5";"0.5";"0.0";"1.0";"0.0";"1.0";"0.0";"1"
"2881736";"sandharb";"4";"0";"4";"3";"1";"4";"0";"0";"null";"null";"0.0";"1.0";"0.75";"0.25";"1.0";"0.0";"0.0";"1"
"383200";"Takuto";"5268";"5267";"1";"5267";"1";"3294";"1974";"181";"null";"null";"0.9998101746393319";"1.8982536066818528E-4";"0.9998101746393319";"1.8982536066818528E-4";"0.6252847380410023";"0.37471526195899774";"0.034358390280941536";"24"
"2885833";"serobinson";"242";"241";"1";"0";"242";"242";"0";"0";"null";"null";"0.9958677685950413";"0.004132231404958678";"0.0";"1.0";"1.0";"0.0";"0.0";"5"
"3803347";"Allstar Seaworthy";"3";"2";"1";"2";"1";"3";"0";"0";"null";"null";"0.6666666666666666";"0.3333333333333333";"0.6666666666666666";"0.3333333333333333";"1.0";"0.0";"0.0";"1"
"1526012";"Bhandari Arun";"475";"131";"344";"474";"1";"287";"188";"38";"null";"null";"0.27578947368421053";"0.7242105263157895";"0.9978947368421053";"0.002105263157894737";"0.6042105263157894";"0.3957894736842105";"0.08";"30"
"2869440";"Salvo1989";"25";"24";"1";"24";"1";"24";"1";"0";"null";"null";"0.96";"0.04";"0.96";"0.04";"0.96";"0.04";"0.0";"3"
"1906921";"atmishshunt";"4";"3";"1";"3";"1";"4";"0";"0";"null";"null";"0.75";"0.25";"0.75";"0.25";"1.0";"0.0";"0.0";"1"
"2238676";"LeoSpat";"31";"0";"31";"30";"1";"21";"10";"8";"null";"null";"0.0";"1.0";"0.967741935483871";"0.03225806451612903";"0.6774193548387096";"0.3225806451612903";"0.25806451612903225";"6"
"3565760";"bishal ghimire";"5";"4";"1";"4";"1";"4";"1";"0";"null";"null";"0.8";"0.2";"0.8";"0.2";"0.8";"0.2";"0.0";"1"
"4458685";"Kiran Grg";"1";"0";"1";"0";"1";"1";"0";"0";"null";"null";"0.0";"1.0";"0.0";"1.0";"1.0";"0.0";"0.0";"1"
"2541869";"yeti7";"35";"34";"1";"0";"35";"20";"15";"10";"null";"null";"0.9714285714285714";"0.02857142857142857";"0.0";"1.0";"0.5714285714285714";"0.42857142857142855";"0.2857142857142857";"2"
"2558250";"Sudha Shakya";"4";"3";"1";"3";"1";"4";"0";"0";"null";"null";"0.75";"0.25";"0.75";"0.25";"1.0";"0.0";"0.0";"1"
"5003613";"Roshan Jha";"1";"0";"1";"0";"1";"1";"0";"0";"null";"null";"0.0";"1.0";"0.0";"1.0";"1.0";"0.0";"0.0";"1"
"4991320";"Chini Bajracharya";"2";"0";"2";"1";"1";"0";"2";"0";"null";"null";"0.0";"1.0";"0.5";"0.5";"0.0";"1.0";"0.0";"1"
"4557139";"Dhanwantari Bhatt";"1";"0";"1";"0";"1";"1";"0";"0";"null";"null";"0.0";"1.0";"0.0";"1.0";"1.0";"0.0";"0.0";"1"
"67862";"HolgerJeromin";"2";"1";"1";"1";"1";"0";"2";"1";"null";"null";"0.5";"0.5";"0.5";"0.5";"0.0";"1.0";"0.5";"1"
"2136376";"luiz_assis";"12";"0";"12";"11";"1";"12";"0";"0";"null";"null";"0.0";"1.0";"0.9166666666666666";"0.08333333333333333";"1.0";"0.0";"0.0";"1"
"1235208";"Niru Pradhan";"94";"79";"15";"79";"15";"68";"26";"9";"null";"null";"0.8404255319148937";"0.1595744680851064";"0.8404255319148937";"0.1595744680851064";"0.723404255319149";"0.2765957446808511";"0.09574468085106383";"24"
"2873649";"Abhinavdwa";"8";"7";"1";"7";"1";"4";"4";"0";"null";"null";"0.875";"0.125";"0.875";"0.125";"0.5";"0.5";"0.0";"2"
"5003606";"anil kayastha";"1";"0";"1";"0";"1";"1";"0";"0";"null";"null";"0.0";"1.0";"0.0";"1.0";"1.0";"0.0";"0.0";"1"
"3795238";"Diipak Shrestha";"1";"0";"1";"0";"1";"1";"0";"0";"null";"null";"0.0";"1.0";"0.0";"1.0";"1.0";"0.0";"0.0";"1"
"710954";"munikarmanish";"163";"117";"46";"162";"1";"31";"132";"39";"null";"null";"0.7177914110429447";"0.2822085889570552";"0.9938650306748467";"0.006134969325153374";"0.1901840490797546";"0.8098159509202454";"0.2392638036809816";"11"
"4106524";"Sanu Kumar Tamang";"21";"3";"18";"20";"1";"16";"5";"0";"null";"null";"0.14285714285714285";"0.8571428571428571";"0.9523809523809523";"0.047619047619047616";"0.7619047619047619";"0.23809523809523808";"0.0";"6"
"2902281";"Anil shing Rai";"4";"3";"1";"0";"4";"3";"1";"0";"null";"null";"0.75";"0.25";"0.0";"1.0";"0.75";"0.25";"0.0";"2"
"3811612";"Paneru Ishan";"3";"0";"3";"2";"1";"3";"0";"0";"null";"null";"0.0";"1.0";"0.6666666666666666";"0.3333333333333333";"1.0";"0.0";"0.0";"1"
"1968436";"andrewrasner";"4";"0";"4";"3";"1";"0";"4";"0";"null";"null";"0.0";"1.0";"0.75";"0.25";"0.0";"1.0";"0.0";"1"
"2902274";"Smap000";"2";"1";"1";"1";"1";"1";"1";"0";"null";"null";"0.5";"0.5";"0.5";"0.5";"0.5";"0.5";"0.0";"2"
"1706292";"Madur";"1";"0";"1";"0";"1";"0";"1";"0";"null";"null";"0.0";"1.0";"0.0";"1.0";"0.0";"1.0";"0.0";"1"
"2877722";"Helina Shrestha";"629";"586";"43";"602";"27";"452";"177";"54";"null";"null";"0.931637519872814";"0.06836248012718601";"0.9570747217806042";"0.04292527821939587";"0.7186009538950715";"0.28139904610492844";"0.08585055643879173";"16"
"4970864";"Ganesh G C";"1";"0";"1";"0";"1";"1";"0";"0";"null";"null";"0.0";"1.0";"0.0";"1.0";"1.0";"0.0";"0.0";"1"
"2693481";"sumansara";"113";"96";"17";"50";"63";"63";"50";"9";"null";"null";"0.8495575221238938";"0.1504424778761062";"0.4424778761061947";"0.5575221238938053";"0.5575221238938053";"0.4424778761061947";"0.07964601769911504";"22"
"239936";"Agile Eye";"105";"80";"25";"96";"9";"29";"76";"7";"null";"null";"0.7619047619047619";"0.23809523809523808";"0.9142857142857143";"0.08571428571428572";"0.2761904761904762";"0.7238095238095238";"0.06666666666666667";"23"
"2376";"Bman";"2";"1";"1";"1";"1";"0";"2";"0";"null";"null";"0.5";"0.5";"0.5";"0.5";"0.0";"1.0";"0.0";"1"
"2238825";"VladSol";"1";"0";"1";"0";"1";"0";"1";"1";"null";"null";"0.0";"1.0";"0.0";"1.0";"0.0";"1.0";"1.0";"1"
"2865508";"Navajeet Khatri";"6";"5";"1";"5";"1";"6";"0";"0";"null";"null";"0.8333333333333334";"0.16666666666666666";"0.8333333333333334";"0.16666666666666666";"1.0";"0.0";"0.0";"2"
"616774";"mueschel";"24";"1";"23";"23";"1";"0";"24";"23";"null";"null";"0.041666666666666664";"0.9583333333333334";"0.9583333333333334";"0.041666666666666664";"0.0";"1.0";"0.9583333333333334";"2"
"2865528";"Migun Shakya";"6";"5";"1";"5";"1";"6";"0";"0";"null";"null";"0.8333333333333334";"0.16666666666666666";"0.8333333333333334";"0.16666666666666666";"1.0";"0.0";"0.0";"3"
"4897055";"krishnakc";"4";"2";"2";"3";"1";"1";"3";"0";"null";"null";"0.5";"0.5";"0.75";"0.25";"0.25";"0.75";"0.0";"4"
"1702220";"tijlr";"4";"0";"4";"3";"1";"4";"0";"0";"null";"null";"0.0";"1.0";"0.75";"0.25";"1.0";"0.0";"0.0";"1"
"2455923";"suyogya";"48";"0";"48";"47";"1";"40";"8";"4";"null";"null";"0.0";"1.0";"0.9791666666666666";"0.020833333333333332";"0.8333333333333334";"0.16666666666666666";"0.08333333333333333";"10"
"2865523";"RobertoRocha";"12";"11";"1";"11";"1";"12";"0";"0";"null";"null";"0.9166666666666666";"0.08333333333333333";"0.9166666666666666";"0.08333333333333333";"1.0";"0.0";"0.0";"3"
"2238840";"YKoirala";"16";"0";"16";"15";"1";"12";"4";"4";"null";"null";"0.0";"1.0";"0.9375";"0.0625";"0.75";"0.25";"0.25";"1"
"2877808";"crysjocy";"35";"0";"35";"34";"1";"14";"21";"0";"null";"null";"0.0";"1.0";"0.9714285714285714";"0.02857142857142857";"0.4";"0.6";"0.0";"8"
"2865520";"marcelagveloz";"22";"0";"22";"21";"1";"22";"0";"0";"null";"null";"0.0";"1.0";"0.9545454545454546";"0.045454545454545456";"1.0";"0.0";"0.0";"1"
"2873719";"David Norrish";"24";"23";"1";"23";"1";"21";"3";"0";"null";"null";"0.9583333333333334";"0.041666666666666664";"0.9583333333333334";"0.041666666666666664";"0.875";"0.125";"0.0";"4"
"2935117";"be best";"30";"0";"30";"29";"1";"4";"26";"18";"null";"null";"0.0";"1.0";"0.9666666666666667";"0.03333333333333333";"0.13333333333333333";"0.8666666666666667";"0.6";"5"
"2865486";"Billy Keng-Han Wu";"5";"0";"5";"4";"1";"3";"2";"1";"null";"null";"0.0";"1.0";"0.8";"0.2";"0.6";"0.4";"0.2";"2"
"2865475";"Lippy Face";"437";"211";"226";"436";"1";"412";"25";"7";"null";"null";"0.482837528604119";"0.517162471395881";"0.9977116704805492";"0.002288329519450801";"0.9427917620137299";"0.057208237986270026";"0.016018306636155607";"21"
"3860818";"Oleg  Gurov";"1";"0";"1";"0";"1";"1";"0";"0";"null";"null";"0.0";"1.0";"0.0";"1.0";"1.0";"0.0";"0.0";"1"
"686439";"85East";"22";"21";"1";"21";"1";"20";"2";"0";"null";"null";"0.9545454545454546";"0.045454545454545456";"0.9545454545454546";"0.045454545454545456";"0.9090909090909091";"0.09090909090909091";"0.0";"4"
"182643";"temporalista";"1263";"0";"1263";"1262";"1";"895";"368";"125";"null";"null";"0.0";"1.0";"0.9992082343626286";"7.91765637371338E-4";"0.7086302454473475";"0.2913697545526524";"0.09897070467141726";"4"
"3963214";"LibbyBell";"6";"4";"2";"5";"1";"5";"1";"0";"null";"null";"0.6666666666666666";"0.3333333333333333";"0.8333333333333334";"0.16666666666666666";"0.8333333333333334";"0.16666666666666666";"0.0";"4"
"2529620";"geomaticsgeomatics";"10";"0";"10";"0";"10";"10";"0";"0";"null";"null";"0.0";"1.0";"0.0";"1.0";"1.0";"0.0";"0.0";"1"
"2869587";"anb22";"4";"3";"1";"3";"1";"0";"4";"0";"null";"null";"0.75";"0.25";"0.75";"0.25";"0.0";"1.0";"0.0";"1"
"4540732";"Ruud Claassen";"2";"1";"1";"0";"2";"1";"1";"0";"null";"null";"0.5";"0.5";"0.0";"1.0";"0.5";"0.5";"0.0";"2"
"4938038";"Shawn10";"2";"0";"2";"1";"1";"2";"0";"0";"null";"null";"0.0";"1.0";"0.5";"0.5";"1.0";"0.0";"0.0";"1"
"2890159";"Pia van Benthem";"20";"0";"20";"19";"1";"20";"0";"0";"null";"null";"0.0";"1.0";"0.95";"0.05";"1.0";"0.0";"0.0";"1"
"543117";"agathe da blues";"33";"3";"30";"32";"1";"28";"5";"1";"null";"null";"0.09090909090909091";"0.9090909090909091";"0.9696969696969697";"0.030303030303030304";"0.8484848484848485";"0.15151515151515152";"0.030303030303030304";"15"
"2877869";"karuishi232";"370";"369";"1";"369";"1";"354";"16";"4";"null";"null";"0.9972972972972973";"0.002702702702702703";"0.9972972972972973";"0.002702702702702703";"0.9567567567567568";"0.043243243243243246";"0.010810810810810811";"4"
"4463043";"Anne D";"2";"1";"1";"1";"1";"2";"0";"0";"null";"null";"0.5";"0.5";"0.5";"0.5";"1.0";"0.0";"0.0";"1"
"199058";"pegeka";"8";"7";"1";"0";"8";"0";"8";"0";"null";"null";"0.875";"0.125";"0.0";"1.0";"0.0";"1.0";"0.0";"1"
"2877881";"Hykw4725";"267";"266";"1";"266";"1";"223";"44";"23";"null";"null";"0.9962546816479401";"0.003745318352059925";"0.9962546816479401";"0.003745318352059925";"0.8352059925093633";"0.1647940074906367";"0.08614232209737828";"41"
"567706";"ed kimber";"40";"0";"40";"0";"40";"0";"40";"0";"null";"null";"0.0";"1.0";"0.0";"1.0";"0.0";"1.0";"0.0";"1"
"2873785";"Rashmina";"1";"0";"1";"0";"1";"1";"0";"0";"null";"null";"0.0";"1.0";"0.0";"1.0";"1.0";"0.0";"0.0";"1"
"4819421";"Manoj Lal Shrestha";"4";"1";"3";"0";"4";"3";"1";"0";"null";"null";"0.25";"0.75";"0.0";"1.0";"0.75";"0.25";"0.0";"4"
"2931131";"Pramod Khatiwada";"1";"0";"1";"0";"1";"1";"0";"0";"null";"null";"0.0";"1.0";"0.0";"1.0";"1.0";"0.0";"0.0";"1"
"2763186";"eigek";"16";"0";"16";"15";"1";"16";"0";"0";"null";"null";"0.0";"1.0";"0.9375";"0.0625";"1.0";"0.0";"0.0";"1"
"4762067";"MKS Pashmina";"2";"0";"2";"0";"2";"2";"0";"0";"null";"null";"0.0";"1.0";"0.0";"1.0";"1.0";"0.0";"0.0";"1"
"2898354";"gwoxford";"43";"0";"43";"42";"1";"43";"0";"0";"null";"null";"0.0";"1.0";"0.9767441860465116";"0.023255813953488372";"1.0";"0.0";"0.0";"3"
"1972608";"rabon";"1";"0";"1";"0";"1";"0";"1";"1";"null";"null";"0.0";"1.0";"0.0";"1.0";"0.0";"1.0";"1.0";"1"
"2877876";"s21453051";"428";"427";"1";"427";"1";"428";"0";"0";"null";"null";"0.9976635514018691";"0.002336448598130841";"0.9976635514018691";"0.002336448598130841";"1.0";"0.0";"0.0";"1"
"2414976";"Bungy Nepal";"4";"1";"3";"3";"1";"3";"1";"0";"null";"null";"0.25";"0.75";"0.75";"0.25";"0.75";"0.25";"0.0";"2"
"1419697";"kanji14134";"100";"95";"5";"4";"96";"48";"52";"0";"null";"null";"0.95";"0.05";"0.04";"0.96";"0.48";"0.52";"0.0";"2"
"2259332";"kebib";"33";"32";"1";"32";"1";"15";"18";"17";"null";"null";"0.9696969696969697";"0.030303030303030304";"0.9696969696969697";"0.030303030303030304";"0.45454545454545453";"0.5454545454545454";"0.5151515151515151";"2"
"4835810";"Prabin Ojha";"2";"1";"1";"1";"1";"2";"0";"0";"null";"null";"0.5";"0.5";"0.5";"0.5";"1.0";"0.0";"0.0";"1"
"4921851";"Thebookofoli";"2";"1";"1";"0";"2";"1";"1";"0";"null";"null";"0.5";"0.5";"0.0";"1.0";"0.5";"0.5";"0.0";"2"
"4971003";"Anil_Maharjan";"2";"0";"2";"1";"1";"2";"0";"0";"null";"null";"0.0";"1.0";"0.5";"0.5";"1.0";"0.0";"0.0";"1"
"4467189";"Andrew Richey I";"7";"3";"4";"5";"2";"5";"2";"0";"null";"null";"0.42857142857142855";"0.5714285714285714";"0.7142857142857143";"0.2857142857142857";"0.7142857142857143";"0.2857142857142857";"0.0";"5"
"4872699";"Rabi Timalsina";"2";"0";"2";"0";"2";"2";"0";"0";"null";"null";"0.0";"1.0";"0.0";"1.0";"1.0";"0.0";"0.0";"2"
"4999673";"Sa Ja N Rb";"1";"0";"1";"0";"1";"1";"0";"0";"null";"null";"0.0";"1.0";"0.0";"1.0";"1.0";"0.0";"0.0";"1"
"3791237";"idwaker";"1";"0";"1";"0";"1";"1";"0";"0";"null";"null";"0.0";"1.0";"0.0";"1.0";"1.0";"0.0";"0.0";"1"
"1747365";"pegel";"189";"0";"189";"0";"189";"116";"73";"69";"null";"null";"0.0";"1.0";"0.0";"1.0";"0.6137566137566137";"0.3862433862433862";"0.36507936507936506";"3"
"3873156";"gita28797";"1";"0";"1";"0";"1";"1";"0";"0";"null";"null";"0.0";"1.0";"0.0";"1.0";"1.0";"0.0";"0.0";"1"
"3271153";"apekshagurung";"26";"0";"26";"25";"1";"13";"13";"12";"null";"null";"0.0";"1.0";"0.9615384615384616";"0.038461538461538464";"0.5";"0.5";"0.46153846153846156";"1"
"178626";"Rovastar";"2";"0";"2";"1";"1";"0";"2";"0";"null";"null";"0.0";"1.0";"0.5";"0.5";"0.0";"1.0";"0.0";"1"
"4884874";"Jbsuman";"1";"0";"1";"0";"1";"1";"0";"0";"null";"null";"0.0";"1.0";"0.0";"1.0";"1.0";"0.0";"0.0";"1"
"870861";"user_870861";"8";"0";"8";"7";"1";"0";"8";"8";"null";"null";"0.0";"1.0";"0.875";"0.125";"0.0";"1.0";"1.0";"1"
"223681";"Wim L";"704";"0";"704";"703";"1";"542";"162";"13";"null";"null";"0.0";"1.0";"0.9985795454545454";"0.0014204545454545455";"0.7698863636363636";"0.23011363636363635";"0.018465909090909092";"3"
"2767343";"Science Shrestha";"44";"7";"37";"43";"1";"44";"0";"0";"null";"null";"0.1590909090909091";"0.8409090909090909";"0.9772727272727273";"0.022727272727272728";"1.0";"0.0";"0.0";"3"
"2689518";"Mohan Singh Bomrel";"14";"13";"1";"0";"14";"6";"8";"6";"null";"null";"0.9285714285714286";"0.07142857142857142";"0.0";"1.0";"0.42857142857142855";"0.5714285714285714";"0.42857142857142855";"4"
"3373567";"Diwas shrestha";"10";"9";"1";"9";"1";"9";"1";"0";"null";"null";"0.9";"0.1";"0.9";"0.1";"0.9";"0.1";"0.0";"2"
"940481";"xtile";"23";"22";"1";"0";"23";"19";"4";"0";"null";"null";"0.9565217391304348";"0.043478260869565216";"0.0";"1.0";"0.8260869565217391";"0.17391304347826086";"0.0";"6"
"2877944";"sarahaliceparker";"276";"178";"98";"275";"1";"275";"1";"0";"null";"null";"0.644927536231884";"0.35507246376811596";"0.9963768115942029";"0.0036231884057971015";"0.9963768115942029";"0.0036231884057971015";"0.0";"30"
"4274586";"Arun Kapali";"1";"0";"1";"0";"1";"1";"0";"0";"null";"null";"0.0";"1.0";"0.0";"1.0";"1.0";"0.0";"0.0";"1"
"5040529";"yjnt";"1";"0";"1";"0";"1";"1";"0";"0";"null";"null";"0.0";"1.0";"0.0";"1.0";"1.0";"0.0";"0.0";"1"
"1223154";"bddavidson";"36";"0";"36";"35";"1";"36";"0";"0";"null";"null";"0.0";"1.0";"0.9722222222222222";"0.027777777777777776";"1.0";"0.0";"0.0";"1"
"2877898";"須田桂子";"93";"92";"1";"92";"1";"71";"22";"0";"null";"null";"0.989247311827957";"0.010752688172043012";"0.989247311827957";"0.010752688172043012";"0.7634408602150538";"0.23655913978494625";"0.0";"5"
"563692";"wilsaj";"638";"32";"606";"480";"158";"601";"37";"9";"null";"null";"0.050156739811912224";"0.9498432601880877";"0.7523510971786834";"0.2476489028213166";"0.9420062695924765";"0.05799373040752351";"0.014106583072100314";"16"
"3611089";"Stha_Sravan";"3";"0";"3";"2";"1";"1";"2";"1";"null";"null";"0.0";"1.0";"0.6666666666666666";"0.3333333333333333";"0.3333333333333333";"0.6666666666666666";"0.3333333333333333";"2"
"2636238";"rabisharma";"10";"0";"10";"9";"1";"9";"1";"1";"null";"null";"0.0";"1.0";"0.9";"0.1";"0.9";"0.1";"0.1";"3"
"3086788";"Rabi Thapa";"10";"9";"1";"9";"1";"2";"8";"7";"null";"null";"0.9";"0.1";"0.9";"0.1";"0.2";"0.8";"0.7";"3"
"2877888";"aruma1";"407";"200";"207";"406";"1";"384";"23";"13";"null";"null";"0.4914004914004914";"0.5085995085995086";"0.9975429975429976";"0.002457002457002457";"0.9434889434889435";"0.056511056511056514";"0.03194103194103194";"7"
"3271130";"narensth";"31";"0";"31";"30";"1";"31";"0";"0";"null";"null";"0.0";"1.0";"0.967741935483871";"0.03225806451612903";"1.0";"0.0";"0.0";"1"
"2861509";"NoOneShEre";"22";"21";"1";"21";"1";"22";"0";"0";"null";"null";"0.9545454545454546";"0.045454545454545456";"0.9545454545454546";"0.045454545454545456";"1.0";"0.0";"0.0";"1"
"2898370";"Jessica Uy";"89";"0";"89";"88";"1";"89";"0";"0";"null";"null";"0.0";"1.0";"0.9887640449438202";"0.011235955056179775";"1.0";"0.0";"0.0";"3"
"2865604";"YYC_Dave";"268";"0";"268";"267";"1";"268";"0";"0";"null";"null";"0.0";"1.0";"0.996268656716418";"0.0037313432835820895";"1.0";"0.0";"0.0";"1"
"522742";"josmougn";"412";"181";"231";"233";"179";"316";"96";"14";"null";"null";"0.4393203883495146";"0.5606796116504854";"0.5655339805825242";"0.4344660194174757";"0.7669902912621359";"0.23300970873786409";"0.03398058252427184";"44"
"2595286";"Daisyfields75";"865";"0";"865";"864";"1";"456";"409";"248";"null";"null";"0.0";"1.0";"0.9988439306358381";"0.0011560693641618498";"0.5271676300578034";"0.4728323699421965";"0.28670520231213875";"56"
"3693002";"GeoCrazy";"48";"0";"48";"47";"1";"6";"42";"2";"null";"null";"0.0";"1.0";"0.9791666666666666";"0.020833333333333332";"0.125";"0.875";"0.041666666666666664";"5"
"563706";"RAHinton";"18";"0";"18";"17";"1";"5";"13";"5";"null";"null";"0.0";"1.0";"0.9444444444444444";"0.05555555555555555";"0.2777777777777778";"0.7222222222222222";"0.2777777777777778";"3"
"2877912";"umeda";"111";"110";"1";"110";"1";"93";"18";"17";"null";"null";"0.990990990990991";"0.009009009009009009";"0.990990990990991";"0.009009009009009009";"0.8378378378378378";"0.16216216216216217";"0.15315315315315314";"19"
"2058725";"soledji";"88";"0";"88";"0";"88";"81";"7";"4";"null";"null";"0.0";"1.0";"0.0";"1.0";"0.9204545454545454";"0.07954545454545454";"0.045454545454545456";"4"
"326143";"Dhruba Adhikari";"1";"0";"1";"0";"1";"1";"0";"0";"null";"null";"0.0";"1.0";"0.0";"1.0";"1.0";"0.0";"0.0";"1"
"3869124";"दिप श्रेष्ठ";"2";"1";"1";"0";"2";"2";"0";"0";"null";"null";"0.5";"0.5";"0.0";"1.0";"1.0";"0.0";"0.0";"2"
"1915421";"devendrashres";"1";"0";"1";"0";"1";"1";"0";"0";"null";"null";"0.0";"1.0";"0.0";"1.0";"1.0";"0.0";"0.0";"1"
"346624";"mahesh thapa";"6";"1";"5";"1";"5";"6";"0";"0";"null";"null";"0.16666666666666666";"0.8333333333333334";"0.16666666666666666";"0.8333333333333334";"1.0";"0.0";"0.0";"6"
"2865699";"feftekhari";"43";"42";"1";"42";"1";"43";"0";"0";"null";"null";"0.9767441860465116";"0.023255813953488372";"0.9767441860465116";"0.023255813953488372";"1.0";"0.0";"0.0";"2"
"2218539";"Gato Maps";"357";"356";"1";"0";"357";"357";"0";"0";"null";"null";"0.9971988795518207";"0.0028011204481792717";"0.0";"1.0";"1.0";"0.0";"0.0";"2"
"424456";"sagara1020";"8";"0";"8";"0";"8";"8";"0";"0";"null";"null";"0.0";"1.0";"0.0";"1.0";"1.0";"0.0";"0.0";"2"
"4991555";"dipak shahi";"3";"2";"1";"2";"1";"3";"0";"0";"null";"null";"0.6666666666666666";"0.3333333333333333";"0.6666666666666666";"0.3333333333333333";"1.0";"0.0";"0.0";"2"
"4655702";"Sudit Maharjan";"3";"1";"2";"2";"1";"3";"0";"0";"null";"null";"0.3333333333333333";"0.6666666666666666";"0.6666666666666666";"0.3333333333333333";"1.0";"0.0";"0.0";"2"
"2886201";"Sylvanowner";"114";"0";"114";"0";"114";"114";"0";"0";"null";"null";"0.0";"1.0";"0.0";"1.0";"1.0";"0.0";"0.0";"1"
"219668";"sev_osm";"19";"1";"18";"1";"18";"2";"17";"8";"null";"null";"0.05263157894736842";"0.9473684210526315";"0.05263157894736842";"0.9473684210526315";"0.10526315789473684";"0.8947368421052632";"0.42105263157894735";"2"
"4065829";"andykas";"2";"1";"1";"1";"1";"2";"0";"0";"null";"null";"0.5";"0.5";"0.5";"0.5";"1.0";"0.0";"0.0";"2"
"2865718";"javigomezb";"270";"0";"270";"269";"1";"221";"49";"0";"null";"null";"0.0";"1.0";"0.9962962962962963";"0.003703703703703704";"0.8185185185185185";"0.1814814814814815";"0.0";"2"
"39457";"Markus59";"1";"0";"1";"0";"1";"0";"1";"0";"null";"null";"0.0";"1.0";"0.0";"1.0";"0.0";"1.0";"0.0";"1"
"1436214";"pipapepita";"87";"85";"2";"62";"25";"72";"15";"0";"null";"null";"0.9770114942528736";"0.022988505747126436";"0.7126436781609196";"0.28735632183908044";"0.8275862068965517";"0.1724137931034483";"0.0";"8"
"2877967";"ritujane";"2";"1";"1";"1";"1";"1";"1";"1";"null";"null";"0.5";"0.5";"0.5";"0.5";"0.5";"0.5";"0.5";"1"
"2877966";"Dávid Kárai";"24";"23";"1";"23";"1";"8";"16";"4";"null";"null";"0.9583333333333334";"0.041666666666666664";"0.9583333333333334";"0.041666666666666664";"0.3333333333333333";"0.6666666666666666";"0.16666666666666666";"1"
"2865678";"Seung Kyum Kim";"168";"0";"168";"167";"1";"121";"47";"4";"null";"null";"0.0";"1.0";"0.9940476190476191";"0.005952380952380952";"0.7202380952380952";"0.27976190476190477";"0.023809523809523808";"14"
"3000837";"Chhunta";"1";"0";"1";"0";"1";"0";"1";"0";"null";"null";"0.0";"1.0";"0.0";"1.0";"0.0";"1.0";"0.0";"1"
"4786787";"Sanjog Sigdel";"5";"2";"3";"4";"1";"3";"2";"0";"null";"null";"0.4";"0.6";"0.8";"0.2";"0.6";"0.4";"0.0";"4"
"4872807";"sn4j";"4";"2";"2";"3";"1";"4";"0";"0";"null";"null";"0.5";"0.5";"0.75";"0.25";"1.0";"0.0";"0.0";"4"
"973373";"chihchun";"6";"5";"1";"5";"1";"5";"1";"0";"null";"null";"0.8333333333333334";"0.16666666666666666";"0.8333333333333334";"0.16666666666666666";"0.8333333333333334";"0.16666666666666666";"0.0";"2"
"2890265";"24367dfa";"380";"0";"380";"379";"1";"239";"141";"0";"null";"null";"0.0";"1.0";"0.9973684210526316";"0.002631578947368421";"0.6289473684210526";"0.37105263157894736";"0.0";"6"
"2226712";"dannykath";"38";"0";"38";"37";"1";"27";"11";"5";"null";"null";"0.0";"1.0";"0.9736842105263158";"0.02631578947368421";"0.7105263157894737";"0.2894736842105263";"0.13157894736842105";"3"
"2931222";"EG3R";"141";"71";"70";"99";"42";"132";"9";"9";"null";"null";"0.5035460992907801";"0.49645390070921985";"0.7021276595744681";"0.2978723404255319";"0.9361702127659575";"0.06382978723404255";"0.06382978723404255";"6"
"4799095";"Bajracharya Rajendra";"2";"0";"2";"0";"2";"2";"0";"0";"null";"null";"0.0";"1.0";"0.0";"1.0";"1.0";"0.0";"0.0";"2"
"3836539";"czhunty";"3";"2";"1";"2";"1";"3";"0";"0";"null";"null";"0.6666666666666666";"0.3333333333333333";"0.6666666666666666";"0.3333333333333333";"1.0";"0.0";"0.0";"2"
"4667907";"Salin Giri";"11";"9";"2";"10";"1";"11";"0";"0";"null";"null";"0.8181818181818182";"0.18181818181818182";"0.9090909090909091";"0.09090909090909091";"1.0";"0.0";"0.0";"3"
"5020168";"सोमेश वाग्ले";"2";"1";"1";"1";"1";"1";"1";"0";"null";"null";"0.5";"0.5";"0.5";"0.5";"0.5";"0.5";"0.0";"1"
"2890344";"Jia Min";"64";"0";"64";"63";"1";"64";"0";"0";"null";"null";"0.0";"1.0";"0.984375";"0.015625";"1.0";"0.0";"0.0";"1"
"121415";"edvac";"17";"0";"17";"16";"1";"1";"16";"14";"null";"null";"0.0";"1.0";"0.9411764705882353";"0.058823529411764705";"0.058823529411764705";"0.9411764705882353";"0.8235294117647058";"2"
"2865772";"jjpapez";"47";"0";"47";"46";"1";"47";"0";"0";"null";"null";"0.0";"1.0";"0.9787234042553191";"0.02127659574468085";"1.0";"0.0";"0.0";"4"
"2321003";"prabin karki";"8";"0";"8";"7";"1";"5";"3";"2";"null";"null";"0.0";"1.0";"0.875";"0.125";"0.625";"0.375";"0.25";"2"
"4565517";"Parsg";"5";"4";"1";"4";"1";"4";"1";"0";"null";"null";"0.8";"0.2";"0.8";"0.2";"0.8";"0.2";"0.0";"2"
"2878050";"motomi1111";"403";"402";"1";"402";"1";"400";"3";"0";"null";"null";"0.9975186104218362";"0.0024813895781637717";"0.9975186104218362";"0.0024813895781637717";"0.9925558312655087";"0.007444168734491315";"0.0";"3"
"10829";"myfanwy";"140";"0";"140";"139";"1";"124";"16";"4";"null";"null";"0.0";"1.0";"0.9928571428571429";"0.007142857142857143";"0.8857142857142857";"0.11428571428571428";"0.02857142857142857";"3"
"2321006";"kundanniraula101";"37";"0";"37";"36";"1";"16";"21";"1";"null";"null";"0.0";"1.0";"0.972972972972973";"0.02702702702702703";"0.43243243243243246";"0.5675675675675675";"0.02702702702702703";"1"
"4803079";"Sanit Aggrawal";"1";"0";"1";"0";"1";"1";"0";"0";"null";"null";"0.0";"1.0";"0.0";"1.0";"1.0";"0.0";"0.0";"1"
"2873957";"Barsat";"1";"0";"1";"0";"1";"1";"0";"0";"null";"null";"0.0";"1.0";"0.0";"1.0";"1.0";"0.0";"0.0";"1"
"2947708";"Kriti Bajracharya";"1";"0";"1";"0";"1";"1";"0";"0";"null";"null";"0.0";"1.0";"0.0";"1.0";"1.0";"0.0";"0.0";"1"
"2869881";"cbassett";"16";"15";"1";"15";"1";"8";"8";"0";"null";"null";"0.9375";"0.0625";"0.9375";"0.0625";"0.5";"0.5";"0.0";"2"
"2689658";"kumar108";"17";"0";"17";"0";"17";"0";"17";"0";"null";"null";"0.0";"1.0";"0.0";"1.0";"0.0";"1.0";"0.0";"1"
"2939519";"Kopila";"20";"0";"20";"19";"1";"20";"0";"0";"null";"null";"0.0";"1.0";"0.95";"0.05";"1.0";"0.0";"0.0";"1"
"2632316";"hmjudge";"642";"0";"642";"641";"1";"525";"117";"35";"null";"null";"0.0";"1.0";"0.9984423676012462";"0.001557632398753894";"0.8177570093457944";"0.1822429906542056";"0.05451713395638629";"3"
"2321014";"amytraj";"123";"121";"2";"0";"123";"113";"10";"4";"null";"null";"0.983739837398374";"0.016260162601626018";"0.0";"1.0";"0.9186991869918699";"0.08130081300813008";"0.032520325203252036";"2"
"4966942";"Nima Tsering";"1";"0";"1";"0";"1";"1";"0";"0";"null";"null";"0.0";"1.0";"0.0";"1.0";"1.0";"0.0";"0.0";"1"
"2321013";"Manisha Belbase";"31";"14";"17";"30";"1";"16";"15";"0";"null";"null";"0.45161290322580644";"0.5483870967741935";"0.967741935483871";"0.03225806451612903";"0.5161290322580645";"0.4838709677419355";"0.0";"3"
"2198137";"Fredrik T";"5";"0";"5";"4";"1";"5";"0";"0";"null";"null";"0.0";"1.0";"0.8";"0.2";"1.0";"0.0";"0.0";"1"
"2321018";"manrojit";"174";"76";"98";"33";"141";"132";"42";"15";"null";"null";"0.4367816091954023";"0.5632183908045977";"0.1896551724137931";"0.8103448275862069";"0.7586206896551724";"0.2413793103448276";"0.08620689655172414";"5"
"2873968";"SigridE";"173";"0";"173";"172";"1";"169";"4";"0";"null";"null";"0.0";"1.0";"0.9942196531791907";"0.005780346820809248";"0.976878612716763";"0.023121387283236993";"0.0";"4"
"1804864";"cool8137";"1";"0";"1";"0";"1";"0";"1";"0";"null";"null";"0.0";"1.0";"0.0";"1.0";"0.0";"1.0";"0.0";"1"
"2882167";"Geetashree";"65";"64";"1";"64";"1";"55";"10";"10";"null";"null";"0.9846153846153847";"0.015384615384615385";"0.9846153846153847";"0.015384615384615385";"0.8461538461538461";"0.15384615384615385";"0.15384615384615385";"8"
"2882166";"Mariano palomares";"8";"7";"1";"7";"1";"8";"0";"0";"null";"null";"0.875";"0.125";"0.875";"0.125";"1.0";"0.0";"0.0";"1"
"2321020";"Bhandari Anupp";"10";"0";"10";"9";"1";"10";"0";"0";"null";"null";"0.0";"1.0";"0.9";"0.1";"1.0";"0.0";"0.0";"2"
"5044780";"Pritam Budhathoki";"2";"0";"2";"1";"1";"1";"1";"0";"null";"null";"0.0";"1.0";"0.5";"0.5";"0.5";"0.5";"0.0";"1"
"1948285";"Anup Shrestha";"42";"18";"24";"0";"42";"36";"6";"1";"null";"null";"0.42857142857142855";"0.5714285714285714";"0.0";"1.0";"0.8571428571428571";"0.14285714285714285";"0.023809523809523808";"19"
"1948284";"Dipendra Shrestha";"16";"0";"16";"0";"16";"8";"8";"8";"null";"null";"0.0";"1.0";"0.0";"1.0";"0.5";"0.5";"0.5";"6"
"1948286";"lumana23";"38";"0";"38";"0";"38";"23";"15";"3";"null";"null";"0.0";"1.0";"0.0";"1.0";"0.6052631578947368";"0.39473684210526316";"0.07894736842105263";"9"
"4614693";"Nihosi Gautam";"4";"3";"1";"3";"1";"1";"3";"0";"null";"null";"0.75";"0.25";"0.75";"0.25";"0.25";"0.75";"0.0";"4"
"3082819";"nhorning";"15";"14";"1";"12";"3";"13";"2";"1";"null";"null";"0.9333333333333333";"0.06666666666666667";"0.8";"0.2";"0.8666666666666667";"0.13333333333333333";"0.06666666666666667";"4"
"39534";"techstrom";"84";"46";"38";"83";"1";"77";"7";"0";"null";"null";"0.5476190476190477";"0.4523809523809524";"0.9880952380952381";"0.011904761904761904";"0.9166666666666666";"0.08333333333333333";"0.0";"3"
"60014";"JanMalte";"49";"0";"49";"48";"1";"49";"0";"0";"null";"null";"0.0";"1.0";"0.9795918367346939";"0.02040816326530612";"1.0";"0.0";"0.0";"2"
"4004434";"Shashwat Guragain";"2";"0";"2";"1";"1";"2";"0";"0";"null";"null";"0.0";"1.0";"0.5";"0.5";"1.0";"0.0";"0.0";"1"
"2675";"Eckhart Wörner";"28";"27";"1";"27";"1";"0";"28";"4";"null";"null";"0.9642857142857143";"0.03571428571428571";"0.9642857142857143";"0.03571428571428571";"0.0";"1.0";"0.14285714285714285";"1"
"5012027";"Bivek Shrestha";"1";"0";"1";"0";"1";"1";"0";"0";"null";"null";"0.0";"1.0";"0.0";"1.0";"1.0";"0.0";"0.0";"1"
"191093";"MapNinja";"4";"0";"4";"3";"1";"4";"0";"0";"null";"null";"0.0";"1.0";"0.75";"0.25";"1.0";"0.0";"0.0";"1"
"1747608";"Pramesh";"2";"1";"1";"1";"1";"0";"2";"0";"null";"null";"0.5";"0.5";"0.5";"0.5";"0.0";"1.0";"0.0";"1"
"2505379";"Mukul126";"16";"0";"16";"0";"16";"8";"8";"3";"null";"null";"0.0";"1.0";"0.0";"1.0";"0.5";"0.5";"0.1875";"3"
"2865838";"albhasan";"109";"0";"109";"108";"1";"109";"0";"0";"null";"null";"0.0";"1.0";"0.9908256880733946";"0.009174311926605505";"1.0";"0.0";"0.0";"3"
"4135610";"Dvash Dahal";"2";"0";"2";"0";"2";"2";"0";"0";"null";"null";"0.0";"1.0";"0.0";"1.0";"1.0";"0.0";"0.0";"1"
"1817244";"Helmchen42";"66";"65";"1";"0";"66";"11";"55";"8";"null";"null";"0.9848484848484849";"0.015151515151515152";"0.0";"1.0";"0.16666666666666666";"0.8333333333333334";"0.12121212121212122";"1"
"481934";"iWowik";"110";"52";"58";"107";"3";"79";"31";"7";"null";"null";"0.4727272727272727";"0.5272727272727272";"0.9727272727272728";"0.02727272727272727";"0.7181818181818181";"0.2818181818181818";"0.06363636363636363";"8"
"3873457";"Aviran Gal";"1";"0";"1";"0";"1";"1";"0";"0";"null";"null";"0.0";"1.0";"0.0";"1.0";"1.0";"0.0";"0.0";"1"
"1948311";"krishna2014";"4";"0";"4";"0";"4";"1";"3";"0";"null";"null";"0.0";"1.0";"0.0";"1.0";"0.25";"0.75";"0.0";"1"
"2767547";"Tommylee9849";"709";"241";"468";"708";"1";"415";"294";"141";"null";"null";"0.33991537376586745";"0.6600846262341326";"0.998589562764457";"0.0014104372355430183";"0.5853314527503526";"0.4146685472496474";"0.19887165021156558";"14"
"1948300";"Prasiddha";"5";"4";"1";"0";"5";"2";"3";"0";"null";"null";"0.8";"0.2";"0.0";"1.0";"0.4";"0.6";"0.0";"2"
"3898031";"Almarusla";"3";"0";"3";"2";"1";"3";"0";"0";"null";"null";"0.0";"1.0";"0.6666666666666666";"0.3333333333333333";"1.0";"0.0";"0.0";"2"
"1948298";"Sagar Dahal";"51";"50";"1";"0";"51";"27";"24";"14";"null";"null";"0.9803921568627451";"0.0196078431372549";"0.0";"1.0";"0.5294117647058824";"0.47058823529411764";"0.27450980392156865";"28"
"1948292";"rhoit";"6";"0";"6";"0";"6";"5";"1";"0";"null";"null";"0.0";"1.0";"0.0";"1.0";"0.8333333333333334";"0.16666666666666666";"0.0";"3"
"719507";"Prabesh";"1";"0";"1";"0";"1";"1";"0";"0";"null";"null";"0.0";"1.0";"0.0";"1.0";"1.0";"0.0";"0.0";"1"
"2886321";"joshiap";"30";"0";"30";"0";"30";"12";"18";"14";"null";"null";"0.0";"1.0";"0.0";"1.0";"0.4";"0.6";"0.4666666666666667";"4"
"64159";"Quelbs";"63";"62";"1";"62";"1";"63";"0";"0";"null";"null";"0.9841269841269841";"0.015873015873015872";"0.9841269841269841";"0.015873015873015872";"1.0";"0.0";"0.0";"1"
"953001";"tomasy";"152";"107";"45";"44";"108";"3";"149";"92";"null";"null";"0.7039473684210527";"0.29605263157894735";"0.2894736842105263";"0.7105263157894737";"0.019736842105263157";"0.9802631578947368";"0.6052631578947368";"2"
"2488962";"geof1";"1";"0";"1";"0";"1";"0";"1";"0";"null";"null";"0.0";"1.0";"0.0";"1.0";"0.0";"1.0";"0.0";"1"
"1772211";"4rch";"35";"26";"9";"32";"3";"13";"22";"2";"null";"null";"0.7428571428571429";"0.2571428571428571";"0.9142857142857143";"0.08571428571428572";"0.37142857142857144";"0.6285714285714286";"0.05714285714285714";"6"
"1804978";"Leclerc";"59";"0";"59";"58";"1";"24";"35";"0";"null";"null";"0.0";"1.0";"0.9830508474576272";"0.01694915254237288";"0.4067796610169492";"0.5932203389830508";"0.0";"1"
"154287";"keithonearth";"15";"0";"15";"1";"14";"2";"13";"3";"null";"null";"0.0";"1.0";"0.06666666666666667";"0.9333333333333333";"0.13333333333333333";"0.8666666666666667";"0.2";"2"
"2873988";"GeekNomad";"81";"80";"1";"80";"1";"81";"0";"0";"null";"null";"0.9876543209876543";"0.012345679012345678";"0.9876543209876543";"0.012345679012345678";"1.0";"0.0";"0.0";"1"
"4930302";"SaWziT";"1";"0";"1";"0";"1";"1";"0";"0";"null";"null";"0.0";"1.0";"0.0";"1.0";"1.0";"0.0";"0.0";"1"
"4139658";"Mukunda Shrestha";"2";"0";"2";"0";"2";"2";"0";"0";"null";"null";"0.0";"1.0";"0.0";"1.0";"1.0";"0.0";"0.0";"1"
"338611";"marek kleciak";"31755";"26821";"4934";"29387";"2368";"18199";"13556";"2495";"null";"null";"0.8446228940324358";"0.15537710596756416";"0.9254290662887734";"0.07457093371122658";"0.5731065973862384";"0.42689340261376163";"0.07857030388915132";"265"
"2771601";"Pramod Bhagat";"17";"16";"1";"16";"1";"2";"15";"13";"null";"null";"0.9411764705882353";"0.058823529411764705";"0.9411764705882353";"0.058823529411764705";"0.11764705882352941";"0.8823529411764706";"0.7647058823529411";"5"
"1948322";"ashmi";"26";"25";"1";"0";"26";"24";"2";"0";"null";"null";"0.9615384615384616";"0.038461538461538464";"0.0";"1.0";"0.9230769230769231";"0.07692307692307693";"0.0";"23"
"4168439";"Prabin Shrestha";"4";"2";"2";"3";"1";"4";"0";"0";"null";"null";"0.5";"0.5";"0.75";"0.25";"1.0";"0.0";"0.0";"3"
"3250937";"Rudeep";"10";"0";"10";"4";"6";"3";"7";"0";"null";"null";"0.0";"1.0";"0.4";"0.6";"0.3";"0.7";"0.0";"7"
"2865889";"Fernanda Tellez";"344";"68";"276";"343";"1";"334";"10";"10";"null";"null";"0.19767441860465115";"0.8023255813953488";"0.997093023255814";"0.0029069767441860465";"0.9709302325581395";"0.029069767441860465";"0.029069767441860465";"8"
"2882273";"tcgb201";"8";"0";"8";"7";"1";"7";"1";"0";"null";"null";"0.0";"1.0";"0.875";"0.125";"0.875";"0.125";"0.0";"1"
"3873520";"Angus Gajurel";"1";"0";"1";"0";"1";"1";"0";"0";"null";"null";"0.0";"1.0";"0.0";"1.0";"1.0";"0.0";"0.0";"1"
"1653463";"akdegraff";"125";"0";"125";"0";"125";"109";"16";"0";"null";"null";"0.0";"1.0";"0.0";"1.0";"0.872";"0.128";"0.0";"1"
"4696713";"Bikram Amatya";"2";"0";"2";"0";"2";"2";"0";"0";"null";"null";"0.0";"1.0";"0.0";"1.0";"1.0";"0.0";"0.0";"2"
"359133";"bgirardot";"104";"6";"98";"44";"60";"4";"100";"72";"null";"null";"0.057692307692307696";"0.9423076923076923";"0.4230769230769231";"0.5769230769230769";"0.038461538461538464";"0.9615384615384616";"0.6923076923076923";"9"
"2874099";"taylordietrich";"1";"0";"1";"0";"1";"1";"0";"0";"null";"null";"0.0";"1.0";"0.0";"1.0";"1.0";"0.0";"0.0";"1"
"4569756";"Deepak Paudel";"1";"0";"1";"0";"1";"1";"0";"0";"null";"null";"0.0";"1.0";"0.0";"1.0";"1.0";"0.0";"0.0";"1"
"408282";"Marion Barry";"4";"3";"1";"3";"1";"2";"2";"1";"null";"null";"0.75";"0.25";"0.75";"0.25";"0.5";"0.5";"0.25";"1"
"2865911";"ECastle";"1300";"0";"1300";"1299";"1";"1220";"80";"22";"null";"null";"0.0";"1.0";"0.9992307692307693";"7.692307692307692E-4";"0.9384615384615385";"0.06153846153846154";"0.016923076923076923";"138"
"826065";"Nirab Pudasaini";"865";"675";"190";"707";"158";"263";"602";"366";"null";"null";"0.7803468208092486";"0.21965317919075145";"0.8173410404624277";"0.18265895953757225";"0.3040462427745665";"0.6959537572254335";"0.423121387283237";"47"
"4799124";"Amil Awale";"5";"0";"5";"0";"5";"5";"0";"0";"null";"null";"0.0";"1.0";"0.0";"1.0";"1.0";"0.0";"0.0";"1"
"4811414";"ENRAGO";"1";"0";"1";"0";"1";"1";"0";"0";"null";"null";"0.0";"1.0";"0.0";"1.0";"1.0";"0.0";"0.0";"1"
"719595";"iusmaharjan";"37";"36";"1";"0";"37";"13";"24";"12";"null";"null";"0.972972972972973";"0.02702702702702703";"0.0";"1.0";"0.35135135135135137";"0.6486486486486487";"0.32432432432432434";"1"
"2169536";"FMeier";"4";"0";"4";"3";"1";"4";"0";"0";"null";"null";"0.0";"1.0";"0.75";"0.25";"1.0";"0.0";"0.0";"1"
"563947";"Rory Nealon";"4";"0";"4";"3";"1";"4";"0";"0";"null";"null";"0.0";"1.0";"0.75";"0.25";"1.0";"0.0";"0.0";"1"
"2869964";"kantien";"26";"25";"1";"25";"1";"26";"0";"0";"null";"null";"0.9615384615384616";"0.038461538461538464";"0.9615384615384616";"0.038461538461538464";"1.0";"0.0";"0.0";"3"
"2816707";"money1898";"19";"0";"19";"18";"1";"19";"0";"0";"null";"null";"0.0";"1.0";"0.9473684210526315";"0.05263157894736842";"1.0";"0.0";"0.0";"4"
"2689731";"Nirajp";"4";"3";"1";"0";"4";"0";"4";"4";"null";"null";"0.75";"0.25";"0.0";"1.0";"0.0";"1.0";"1.0";"1"
"719590";"deepsadhi";"4";"0";"4";"0";"4";"4";"0";"0";"null";"null";"0.0";"1.0";"0.0";"1.0";"1.0";"0.0";"0.0";"1"
"4537002";"Manuel Hadler";"1";"0";"1";"0";"1";"1";"0";"0";"null";"null";"0.0";"1.0";"0.0";"1.0";"1.0";"0.0";"0.0";"1"
"715512";"mp3t3r";"92";"0";"92";"91";"1";"82";"10";"0";"null";"null";"0.0";"1.0";"0.9891304347826086";"0.010869565217391304";"0.8913043478260869";"0.10869565217391304";"0.0";"1"
"64243";"Krystek";"575";"0";"575";"574";"1";"495";"80";"12";"null";"null";"0.0";"1.0";"0.9982608695652174";"0.0017391304347826088";"0.8608695652173913";"0.1391304347826087";"0.020869565217391306";"1"
"781054";"Manoj Thapa";"14860";"10543";"4317";"13873";"987";"5063";"9797";"3944";"null";"null";"0.7094885598923284";"0.2905114401076716";"0.9335800807537012";"0.0664199192462988";"0.34071332436069984";"0.6592866756393001";"0.26541049798115746";"298"
"2865884";"alzhong";"61";"0";"61";"60";"1";"61";"0";"0";"null";"null";"0.0";"1.0";"0.9836065573770492";"0.01639344262295082";"1.0";"0.0";"0.0";"2"
"1719066";"Snorkle";"24";"0";"24";"23";"1";"24";"0";"0";"null";"null";"0.0";"1.0";"0.9583333333333334";"0.041666666666666664";"1.0";"0.0";"0.0";"1"
"748291";"Prot D";"198";"0";"198";"197";"1";"198";"0";"0";"null";"null";"0.0";"1.0";"0.9949494949494949";"0.005050505050505051";"1.0";"0.0";"0.0";"3"
"3992374";"Orpheus210";"1";"0";"1";"0";"1";"0";"1";"0";"null";"null";"0.0";"1.0";"0.0";"1.0";"0.0";"1.0";"0.0";"1"
"2808614";"thursdaylady";"12";"0";"12";"11";"1";"12";"0";"0";"null";"null";"0.0";"1.0";"0.9166666666666666";"0.08333333333333333";"1.0";"0.0";"0.0";"1"
"3345214";"Ashish Bastola";"49";"47";"2";"48";"1";"28";"21";"3";"null";"null";"0.9591836734693877";"0.04081632653061224";"0.9795918367346939";"0.02040816326530612";"0.5714285714285714";"0.42857142857142855";"0.061224489795918366";"8"
"2710308";"Gyanu";"1";"0";"1";"0";"1";"1";"0";"0";"null";"null";"0.0";"1.0";"0.0";"1.0";"1.0";"0.0";"0.0";"1"
"2837284";"johnrasmussendk";"1";"0";"1";"0";"1";"1";"0";"0";"null";"null";"0.0";"1.0";"0.0";"1.0";"1.0";"0.0";"0.0";"1"
"2739002";"SAROJ BOGATI";"1";"0";"1";"0";"1";"1";"0";"0";"null";"null";"0.0";"1.0";"0.0";"1.0";"1.0";"0.0";"0.0";"1"
"3222306";"LaxmanKhadka";"12";"0";"12";"11";"1";"12";"0";"0";"null";"null";"0.0";"1.0";"0.9166666666666666";"0.08333333333333333";"1.0";"0.0";"0.0";"1"
"4758366";"NissanK";"1";"0";"1";"0";"1";"1";"0";"0";"null";"null";"0.0";"1.0";"0.0";"1.0";"1.0";"0.0";"0.0";"1"
"2698037";"mayra!";"1441";"0";"1441";"1333";"108";"901";"540";"457";"null";"null";"0.0";"1.0";"0.9250520471894518";"0.07494795281054822";"0.6252602359472589";"0.3747397640527412";"0.31714087439278277";"216"
"3906343";"pujan";"21";"20";"1";"20";"1";"9";"12";"0";"null";"null";"0.9523809523809523";"0.047619047619047616";"0.9523809523809523";"0.047619047619047616";"0.42857142857142855";"0.5714285714285714";"0.0";"3"
"1235724";"jporto";"148";"147";"1";"85";"63";"73";"75";"1";"null";"null";"0.9932432432432432";"0.006756756756756757";"0.5743243243243243";"0.42567567567567566";"0.49324324324324326";"0.5067567567567568";"0.006756756756756757";"4"
"650006";"mikad0";"81";"0";"81";"80";"1";"13";"68";"66";"null";"null";"0.0";"1.0";"0.9876543209876543";"0.012345679012345678";"0.16049382716049382";"0.8395061728395061";"0.8148148148148148";"1"
"4807529";"Dhan Bahadur Rana";"1";"0";"1";"0";"1";"1";"0";"0";"null";"null";"0.0";"1.0";"0.0";"1.0";"1.0";"0.0";"0.0";"1"
"3951389";"Bikram Karki";"2";"0";"2";"1";"1";"2";"0";"0";"null";"null";"0.0";"1.0";"0.5";"0.5";"1.0";"0.0";"0.0";"2"
"4524897";"Claudio Gobantes";"1";"0";"1";"0";"1";"1";"0";"0";"null";"null";"0.0";"1.0";"0.0";"1.0";"1.0";"0.0";"0.0";"1"
"2882317";"badgerr";"163";"162";"1";"162";"1";"163";"0";"0";"null";"null";"0.9938650306748467";"0.006134969325153374";"0.9938650306748467";"0.006134969325153374";"1.0";"0.0";"0.0";"7"
"1829683";"Luis36995";"925";"0";"925";"923";"2";"297";"628";"26";"null";"null";"0.0";"1.0";"0.9978378378378379";"0.002162162162162162";"0.3210810810810811";"0.6789189189189189";"0.02810810810810811";"13"
"2882306";"SRajani";"17";"0";"17";"16";"1";"15";"2";"2";"null";"null";"0.0";"1.0";"0.9411764705882353";"0.058823529411764705";"0.8823529411764706";"0.11764705882352941";"0.11764705882352941";"4"
"4221802";"jagadishpoudel";"1";"0";"1";"0";"1";"0";"1";"0";"null";"null";"0.0";"1.0";"0.0";"1.0";"0.0";"1.0";"0.0";"1"
"2882311";"VHAC";"67";"0";"67";"0";"67";"55";"12";"12";"null";"null";"0.0";"1.0";"0.0";"1.0";"0.8208955223880597";"0.1791044776119403";"0.1791044776119403";"1"
"5016417";"Syncro International";"1";"0";"1";"0";"1";"1";"0";"0";"null";"null";"0.0";"1.0";"0.0";"1.0";"1.0";"0.0";"0.0";"1"
"4746105";"J Maharjan";"103";"0";"103";"102";"1";"17";"86";"75";"null";"null";"0.0";"1.0";"0.9902912621359223";"0.009708737864077669";"0.1650485436893204";"0.8349514563106796";"0.7281553398058253";"7"
"3902217";"Bibek Chalise";"1";"0";"1";"0";"1";"1";"0";"0";"null";"null";"0.0";"1.0";"0.0";"1.0";"1.0";"0.0";"0.0";"1"
"744252";"Buddha_OSM";"8";"7";"1";"7";"1";"4";"4";"4";"null";"null";"0.875";"0.125";"0.875";"0.125";"0.5";"0.5";"0.5";"1"
"4221817";"ranzrz";"24";"23";"1";"23";"1";"24";"0";"0";"null";"null";"0.9583333333333334";"0.041666666666666664";"0.9583333333333334";"0.041666666666666664";"1.0";"0.0";"0.0";"2"
"2861842";"urshula";"11";"10";"1";"0";"11";"10";"1";"0";"null";"null";"0.9090909090909091";"0.09090909090909091";"0.0";"1.0";"0.9090909090909091";"0.09090909090909091";"0.0";"3"
"4914038";"babustha";"1";"0";"1";"0";"1";"1";"0";"0";"null";"null";"0.0";"1.0";"0.0";"1.0";"1.0";"0.0";"0.0";"1"
"2874210";"Omry";"20";"19";"1";"19";"1";"20";"0";"0";"null";"null";"0.95";"0.05";"0.95";"0.05";"1.0";"0.0";"0.0";"5"
"4778778";"Abodh Poudyal";"2";"0";"2";"1";"1";"2";"0";"0";"null";"null";"0.0";"1.0";"0.5";"0.5";"1.0";"0.0";"0.0";"1"
"15188";"Polyglot";"200";"0";"200";"199";"1";"81";"119";"0";"null";"null";"0.0";"1.0";"0.995";"0.005";"0.405";"0.595";"0.0";"2"
"4799260";"Binay Paudyal";"1";"0";"1";"0";"1";"0";"1";"0";"null";"null";"0.0";"1.0";"0.0";"1.0";"0.0";"1.0";"0.0";"1"
"3599200";"geordie013";"1";"0";"1";"0";"1";"1";"0";"0";"null";"null";"0.0";"1.0";"0.0";"1.0";"1.0";"0.0";"0.0";"1"
"2194296";"Jyoti Amatya";"2";"1";"1";"1";"1";"2";"0";"0";"null";"null";"0.5";"0.5";"0.5";"0.5";"1.0";"0.0";"0.0";"2"
"2870128";"aperkinsa1";"2";"1";"1";"1";"1";"2";"0";"0";"null";"null";"0.5";"0.5";"0.5";"0.5";"1.0";"0.0";"0.0";"1"
"3906406";"Ajit Bhatta";"12";"11";"1";"11";"1";"8";"4";"0";"null";"null";"0.9166666666666666";"0.08333333333333333";"0.9166666666666666";"0.08333333333333333";"0.6666666666666666";"0.3333333333333333";"0.0";"2"
"4619042";"Bivishan Pandey";"3";"0";"3";"2";"1";"3";"0";"0";"null";"null";"0.0";"1.0";"0.6666666666666666";"0.3333333333333333";"1.0";"0.0";"0.0";"1"
"961387";"trekker48";"3";"0";"3";"2";"1";"1";"2";"0";"null";"null";"0.0";"1.0";"0.6666666666666666";"0.3333333333333333";"0.3333333333333333";"0.6666666666666666";"0.0";"1"
"4664098";"KoenME";"2";"1";"1";"1";"1";"2";"0";"0";"null";"null";"0.5";"0.5";"0.5";"0.5";"1.0";"0.0";"0.0";"2"
"1805170";"aarondennis";"14";"13";"1";"13";"1";"8";"6";"1";"null";"null";"0.9285714285714286";"0.07142857142857142";"0.9285714285714286";"0.07142857142857142";"0.5714285714285714";"0.42857142857142855";"0.07142857142857142";"1"
"3963733";"Tiv O Hsus";"5";"1";"4";"4";"1";"4";"1";"0";"null";"null";"0.2";"0.8";"0.8";"0.2";"0.8";"0.2";"0.0";"5"
"2194251";"dikesh";"6";"5";"1";"5";"1";"4";"2";"2";"null";"null";"0.8333333333333334";"0.16666666666666666";"0.8333333333333334";"0.16666666666666666";"0.6666666666666666";"0.3333333333333333";"0.3333333333333333";"3"
"2878273";"ashis_np1";"60";"59";"1";"59";"1";"53";"7";"0";"null";"null";"0.9833333333333333";"0.016666666666666666";"0.9833333333333333";"0.016666666666666666";"0.8833333333333333";"0.11666666666666667";"0.0";"3"
"47978";"Christoph Lotz";"1";"0";"1";"0";"1";"0";"1";"0";"null";"null";"0.0";"1.0";"0.0";"1.0";"0.0";"1.0";"0.0";"1"
"588644";"sagarchalise";"8";"2";"6";"3";"5";"5";"3";"1";"null";"null";"0.25";"0.75";"0.375";"0.625";"0.625";"0.375";"0.125";"5"
"2554698";"ruthmaben";"11";"0";"11";"10";"1";"0";"11";"10";"null";"null";"0.0";"1.0";"0.9090909090909091";"0.09090909090909091";"0.0";"1.0";"0.9090909090909091";"1"
"510836";"Rub21";"1";"0";"1";"0";"1";"0";"1";"0";"null";"null";"0.0";"1.0";"0.0";"1.0";"0.0";"1.0";"0.0";"1"
"5053246";"Trevor453";"1";"0";"1";"0";"1";"1";"0";"0";"null";"null";"0.0";"1.0";"0.0";"1.0";"1.0";"0.0";"0.0";"1"
"4500285";"Alex Sharma";"2";"0";"2";"1";"1";"1";"1";"0";"null";"null";"0.0";"1.0";"0.5";"0.5";"0.5";"0.5";"0.0";"1"
"2886485";"MDGautam";"1";"0";"1";"0";"1";"1";"0";"0";"null";"null";"0.0";"1.0";"0.0";"1.0";"1.0";"0.0";"0.0";"1"
"2870098";"fullafan";"4";"3";"1";"3";"1";"4";"0";"0";"null";"null";"0.75";"0.25";"0.75";"0.25";"1.0";"0.0";"0.0";"1"
"1428330";"tmizu23";"62";"0";"62";"0";"62";"62";"0";"0";"null";"null";"0.0";"1.0";"0.0";"1.0";"1.0";"0.0";"0.0";"1"
"4803528";"Eva Blue";"3671";"1416";"2255";"3670";"1";"1261";"2410";"560";"null";"null";"0.3857259602288205";"0.6142740397711796";"0.9997275946608554";"2.7240533914464724E-4";"0.34350313266140015";"0.6564968673385998";"0.15254698992100246";"276"
"2874282";"Lomax10";"5";"4";"1";"4";"1";"5";"0";"0";"null";"null";"0.8";"0.2";"0.8";"0.2";"1.0";"0.0";"0.0";"1"
"5053390";"Binod Basnet";"6";"0";"6";"0";"6";"6";"0";"0";"null";"null";"0.0";"1.0";"0.0";"1.0";"1.0";"0.0";"0.0";"2"
"4041657";"Sujan Dhital";"1";"0";"1";"0";"1";"1";"0";"0";"null";"null";"0.0";"1.0";"0.0";"1.0";"1.0";"0.0";"0.0";"1"
"2558883";"sandeshp";"91";"90";"1";"90";"1";"43";"48";"26";"null";"null";"0.989010989010989";"0.01098901098901099";"0.989010989010989";"0.01098901098901099";"0.4725274725274725";"0.5274725274725275";"0.2857142857142857";"1"
"4594624";"IME Shining Holy Ashoka";"1";"0";"1";"0";"1";"1";"0";"0";"null";"null";"0.0";"1.0";"0.0";"1.0";"1.0";"0.0";"0.0";"1"
"4885442";"Bedana Rai";"2";"1";"1";"0";"2";"1";"1";"1";"null";"null";"0.5";"0.5";"0.0";"1.0";"0.5";"0.5";"0.5";"2"
"3906482";"smitakhanal";"12";"11";"1";"11";"1";"12";"0";"0";"null";"null";"0.9166666666666666";"0.08333333333333333";"0.9166666666666666";"0.08333333333333333";"1.0";"0.0";"0.0";"1"
"4803525";"Shaun Austin";"2451";"1211";"1240";"2450";"1";"760";"1691";"245";"null";"null";"0.4940840473276214";"0.5059159526723787";"0.9995920032639739";"4.079967360261118E-4";"0.31007751937984496";"0.689922480620155";"0.0999592003263974";"220"
"4803527";"Kate Diaz";"2416";"961";"1455";"2415";"1";"851";"1565";"159";"null";"null";"0.3977649006622517";"0.6022350993377483";"0.9995860927152318";"4.139072847682119E-4";"0.3522350993377483";"0.6477649006622517";"0.0658112582781457";"202"
"1051550";"shravan91";"91";"0";"91";"90";"1";"84";"7";"0";"null";"null";"0.0";"1.0";"0.989010989010989";"0.01098901098901099";"0.9230769230769231";"0.07692307692307693";"0.0";"14"
"3521467";"paudel";"6";"5";"1";"5";"1";"4";"2";"1";"null";"null";"0.8333333333333334";"0.16666666666666666";"0.8333333333333334";"0.16666666666666666";"0.6666666666666666";"0.3333333333333333";"0.16666666666666666";"1"
"4934597";"deadlydawn 17";"1";"0";"1";"0";"1";"1";"0";"0";"null";"null";"0.0";"1.0";"0.0";"1.0";"1.0";"0.0";"0.0";"1"
"4803526";"Lexi Johnson";"922";"284";"638";"921";"1";"191";"731";"67";"null";"null";"0.3080260303687636";"0.6919739696312365";"0.9989154013015185";"0.0010845986984815619";"0.20715835140997832";"0.7928416485900217";"0.07266811279826464";"122"
"3476410";"Prasit Aphiphunya";"1";"0";"1";"0";"1";"0";"1";"0";"null";"null";"0.0";"1.0";"0.0";"1.0";"0.0";"1.0";"0.0";"1"
"2878393";"Abhiram Saran";"29";"28";"1";"28";"1";"28";"1";"0";"null";"null";"0.9655172413793104";"0.034482758620689655";"0.9655172413793104";"0.034482758620689655";"0.9655172413793104";"0.034482758620689655";"0.0";"6"
"3120057";"gaurab basnet";"1";"0";"1";"0";"1";"1";"0";"0";"null";"null";"0.0";"1.0";"0.0";"1.0";"1.0";"0.0";"0.0";"1"
"2890683";"vc2017";"25";"0";"25";"24";"1";"11";"14";"14";"null";"null";"0.0";"1.0";"0.96";"0.04";"0.44";"0.56";"0.56";"1"
"4623324";"Tamrakar";"2";"1";"1";"0";"2";"2";"0";"0";"null";"null";"0.5";"0.5";"0.0";"1.0";"1.0";"0.0";"0.0";"2"
"2886583";"S Dutta";"17";"16";"1";"0";"17";"17";"0";"0";"null";"null";"0.9411764705882353";"0.058823529411764705";"0.0";"1.0";"1.0";"0.0";"0.0";"1"
"2427833";"e-cite";"206";"57";"149";"205";"1";"202";"4";"4";"null";"null";"0.2766990291262136";"0.7233009708737864";"0.9951456310679612";"0.0048543689320388345";"0.9805825242718447";"0.019417475728155338";"0.019417475728155338";"4"
"474022";"sashazykov";"69";"41";"28";"55";"14";"36";"33";"17";"null";"null";"0.5942028985507246";"0.4057971014492754";"0.7971014492753623";"0.2028985507246377";"0.5217391304347826";"0.4782608695652174";"0.2463768115942029";"25"
"2882442";"LAGribble";"144";"0";"144";"0";"144";"140";"4";"0";"null";"null";"0.0";"1.0";"0.0";"1.0";"0.9722222222222222";"0.027777777777777776";"0.0";"1"
"2870153";"karmakarma";"204";"203";"1";"0";"204";"177";"27";"5";"null";"null";"0.9950980392156863";"0.004901960784313725";"0.0";"1.0";"0.8676470588235294";"0.1323529411764706";"0.024509803921568627";"1"
"2870158";"vitopepito";"181";"180";"1";"180";"1";"139";"42";"10";"null";"null";"0.994475138121547";"0.0055248618784530384";"0.994475138121547";"0.0055248618784530384";"0.7679558011049724";"0.23204419889502761";"0.055248618784530384";"2"
"564141";"Madmaks";"659";"405";"254";"658";"1";"551";"108";"11";"null";"null";"0.6145675265553869";"0.38543247344461307";"0.9984825493171472";"0.0015174506828528073";"0.8361153262518968";"0.1638846737481032";"0.01669195751138088";"5"
"4139929";"DikshyaD";"32";"23";"9";"23";"9";"20";"12";"12";"null";"null";"0.71875";"0.28125";"0.71875";"0.28125";"0.625";"0.375";"0.375";"5"
"281518";"Iamthemap";"20";"0";"20";"19";"1";"20";"0";"0";"null";"null";"0.0";"1.0";"0.95";"0.05";"1.0";"0.0";"0.0";"1"
"2018229";"Nishant Khanal";"7";"6";"1";"0";"7";"6";"1";"0";"null";"null";"0.8571428571428571";"0.14285714285714285";"0.0";"1.0";"0.8571428571428571";"0.14285714285714285";"0.0";"3"
"355242";"Bryce C Nesbitt";"1";"0";"1";"0";"1";"0";"1";"0";"null";"null";"0.0";"1.0";"0.0";"1.0";"0.0";"1.0";"0.0";"1"
"2866075";"greg_geo";"45";"0";"45";"44";"1";"45";"0";"0";"null";"null";"0.0";"1.0";"0.9777777777777777";"0.022222222222222223";"1.0";"0.0";"0.0";"1"
"4905979";"Megh Nath Rijal";"4";"0";"4";"3";"1";"0";"4";"0";"null";"null";"0.0";"1.0";"0.75";"0.25";"0.0";"1.0";"0.0";"1"
"4824056";"Jeevan Bhattarai";"4";"0";"4";"3";"1";"2";"2";"0";"null";"null";"0.0";"1.0";"0.75";"0.25";"0.5";"0.5";"0.0";"2"
"2079661";"anishrestha";"68";"67";"1";"0";"68";"20";"48";"6";"null";"null";"0.9852941176470589";"0.014705882352941176";"0.0";"1.0";"0.29411764705882354";"0.7058823529411765";"0.08823529411764706";"3"
"2018218";"amish_dhungel";"4";"3";"1";"0";"4";"4";"0";"0";"null";"null";"0.75";"0.25";"0.0";"1.0";"1.0";"0.0";"0.0";"2"
"2861971";"Jeewasmi Thapa";"42";"0";"42";"41";"1";"30";"12";"5";"null";"null";"0.0";"1.0";"0.9761904761904762";"0.023809523809523808";"0.7142857142857143";"0.2857142857142857";"0.11904761904761904";"5"
"27577";"Depsy";"73";"72";"1";"0";"73";"0";"73";"73";"null";"null";"0.9863013698630136";"0.0136986301369863";"0.0";"1.0";"0.0";"1.0";"1.0";"1"
"4934645";"Amrendra Mahato";"2";"0";"2";"1";"1";"2";"0";"0";"null";"null";"0.0";"1.0";"0.5";"0.5";"1.0";"0.0";"0.0";"2"
"2874260";"SIMAR MANN SINGH";"44";"43";"1";"43";"1";"44";"0";"0";"null";"null";"0.9772727272727273";"0.022727272727272728";"0.9772727272727273";"0.022727272727272728";"1.0";"0.0";"0.0";"8"
"2747286";"BNPSurvey";"1";"0";"1";"0";"1";"1";"0";"0";"null";"null";"0.0";"1.0";"0.0";"1.0";"1.0";"0.0";"0.0";"1"
"1964962";"subash thapaliya";"22";"21";"1";"21";"1";"20";"2";"1";"null";"null";"0.9545454545454546";"0.045454545454545456";"0.9545454545454546";"0.045454545454545456";"0.9090909090909091";"0.09090909090909091";"0.045454545454545456";"6"
"2690024";"odd2015harry";"23";"22";"1";"0";"23";"13";"10";"8";"null";"null";"0.9565217391304348";"0.043478260869565216";"0.0";"1.0";"0.5652173913043478";"0.43478260869565216";"0.34782608695652173";"7"
"1731550";"osm-pascal";"43";"0";"43";"42";"1";"43";"0";"0";"null";"null";"0.0";"1.0";"0.9767441860465116";"0.023255813953488372";"1.0";"0.0";"0.0";"1"
"1797085";"Jacek_str";"397";"158";"239";"158";"239";"273";"124";"98";"null";"null";"0.3979848866498741";"0.6020151133501259";"0.3979848866498741";"0.6020151133501259";"0.6876574307304786";"0.3123425692695214";"0.24685138539042822";"6"
"2477037";"behsow";"60";"57";"3";"0";"60";"60";"0";"0";"null";"null";"0.95";"0.05";"0.0";"1.0";"1.0";"0.0";"0.0";"7"
"1911765";"lks1[konto usunięte]";"1";"0";"1";"0";"1";"0";"1";"1";"null";"null";"0.0";"1.0";"0.0";"1.0";"0.0";"1.0";"1.0";"1"
"125897";"overflorian";"137";"0";"137";"136";"1";"137";"0";"0";"null";"null";"0.0";"1.0";"0.9927007299270073";"0.0072992700729927005";"1.0";"0.0";"0.0";"4"
"2898917";"lhabula";"3";"0";"3";"2";"1";"3";"0";"0";"null";"null";"0.0";"1.0";"0.6666666666666666";"0.3333333333333333";"1.0";"0.0";"0.0";"1"
"2898912";"KhushiP";"2";"0";"2";"1";"1";"1";"1";"1";"null";"null";"0.0";"1.0";"0.5";"0.5";"0.5";"0.5";"0.5";"1"
"2898913";"Sraddheya";"44";"0";"44";"43";"1";"44";"0";"0";"null";"null";"0.0";"1.0";"0.9772727272727273";"0.022727272727272728";"1.0";"0.0";"0.0";"7"
"2862053";"kajdsf93";"12";"0";"12";"0";"12";"12";"0";"0";"null";"null";"0.0";"1.0";"0.0";"1.0";"1.0";"0.0";"0.0";"1"
"2898914";"anne4";"2";"0";"2";"1";"1";"0";"2";"0";"null";"null";"0.0";"1.0";"0.5";"0.5";"0.0";"1.0";"0.0";"1"
"2898940";"rubingh";"7";"0";"7";"6";"1";"1";"6";"1";"null";"null";"0.0";"1.0";"0.8571428571428571";"0.14285714285714285";"0.14285714285714285";"0.8571428571428571";"0.14285714285714285";"4"
"3529700";"Mezriyonzazh";"20";"0";"20";"19";"1";"10";"10";"6";"null";"null";"0.0";"1.0";"0.95";"0.05";"0.5";"0.5";"0.3";"4"
"4803484";"Stella Lee";"3391";"1756";"1635";"3390";"1";"850";"2541";"475";"null";"null";"0.517841344736066";"0.4821586552639339";"0.9997051017398997";"2.948982601002654E-4";"0.2506635210852256";"0.7493364789147744";"0.14007667354762607";"246"
"1567682";"Shashwat Kafle";"1270";"496";"774";"1128";"142";"943";"327";"302";"null";"null";"0.3905511811023622";"0.6094488188976378";"0.8881889763779528";"0.11181102362204724";"0.74251968503937";"0.2574803149606299";"0.2377952755905512";"32"
"1903559";"Triton33333";"757";"572";"185";"143";"614";"664";"93";"28";"null";"null";"0.7556142668428005";"0.24438573315719947";"0.18890356671070013";"0.8110964332892999";"0.8771466314398944";"0.12285336856010567";"0.036988110964332896";"18"
"1215436";"nawaraj";"8";"0";"8";"7";"1";"2";"6";"0";"null";"null";"0.0";"1.0";"0.875";"0.125";"0.25";"0.75";"0.0";"1"
"3603414";"Nimisha Wagle";"12";"11";"1";"11";"1";"12";"0";"0";"null";"null";"0.9166666666666666";"0.08333333333333333";"0.9166666666666666";"0.08333333333333333";"1.0";"0.0";"0.0";"1"
"4623270";"Arjun Shrestha";"3";"0";"3";"1";"2";"3";"0";"0";"null";"null";"0.0";"1.0";"0.3333333333333333";"0.6666666666666666";"1.0";"0.0";"0.0";"3"
"2870219";"Ferdous Azad Sadi";"24";"5";"19";"23";"1";"24";"0";"0";"null";"null";"0.20833333333333334";"0.7916666666666666";"0.9583333333333334";"0.041666666666666664";"1.0";"0.0";"0.0";"7"
"2030591";"MichaOSM";"12";"0";"12";"11";"1";"6";"6";"0";"null";"null";"0.0";"1.0";"0.9166666666666666";"0.08333333333333333";"0.5";"0.5";"0.0";"2"
"5016494";"Shambhu Khatri";"1";"0";"1";"0";"1";"0";"1";"0";"null";"null";"0.0";"1.0";"0.0";"1.0";"0.0";"1.0";"0.0";"1"
"2870221";"Spandan";"1";"0";"1";"0";"1";"1";"0";"0";"null";"null";"0.0";"1.0";"0.0";"1.0";"1.0";"0.0";"0.0";"1"
"4463523";"zenzen Thikyepa";"1";"0";"1";"0";"1";"1";"0";"0";"null";"null";"0.0";"1.0";"0.0";"1.0";"1.0";"0.0";"0.0";"1"
"2874305";"Martin Håberg";"89";"83";"6";"88";"1";"79";"10";"0";"null";"null";"0.9325842696629213";"0.06741573033707865";"0.9887640449438202";"0.011235955056179775";"0.8876404494382022";"0.11235955056179775";"0.0";"2"
"1752049";"PrashantNiraula";"18";"17";"1";"0";"18";"12";"6";"4";"null";"null";"0.9444444444444444";"0.05555555555555555";"0.0";"1.0";"0.6666666666666666";"0.3333333333333333";"0.2222222222222222";"13"
"4803512";"kevin Prince";"1204";"463";"741";"1203";"1";"363";"841";"88";"null";"null";"0.3845514950166113";"0.6154485049833887";"0.9991694352159468";"8.305647840531562E-4";"0.3014950166112957";"0.6985049833887044";"0.07308970099667775";"116"
"2898911";"AakritiC";"51";"0";"51";"50";"1";"0";"51";"47";"null";"null";"0.0";"1.0";"0.9803921568627451";"0.0196078431372549";"0.0";"1.0";"0.9215686274509803";"1"
"523251";"greenhalos";"3";"1";"2";"1";"2";"2";"1";"0";"null";"null";"0.3333333333333333";"0.6666666666666666";"0.3333333333333333";"0.6666666666666666";"0.6666666666666666";"0.3333333333333333";"0.0";"3"
"2767838";"illumlu";"58";"0";"58";"57";"1";"58";"0";"0";"null";"null";"0.0";"1.0";"0.9827586206896551";"0.017241379310344827";"1.0";"0.0";"0.0";"5"
"4795324";"Benjamin Lemarechal";"1";"0";"1";"0";"1";"1";"0";"0";"null";"null";"0.0";"1.0";"0.0";"1.0";"1.0";"0.0";"0.0";"1"
"4647856";"Rajan Singhania";"2";"1";"1";"1";"1";"1";"1";"0";"null";"null";"0.5";"0.5";"0.5";"0.5";"0.5";"0.5";"0.0";"2"
"2874332";"alegri";"38";"0";"38";"37";"1";"38";"0";"0";"null";"null";"0.0";"1.0";"0.9736842105263158";"0.02631578947368421";"1.0";"0.0";"0.0";"2"
"4713543";"Barnabechaix";"1";"0";"1";"0";"1";"1";"0";"0";"null";"null";"0.0";"1.0";"0.0";"1.0";"1.0";"0.0";"0.0";"1"
"2886700";"mitu khurana";"5";"4";"1";"0";"5";"5";"0";"0";"null";"null";"0.8";"0.2";"0.0";"1.0";"1.0";"0.0";"0.0";"1"
"515079";"selator";"4";"0";"4";"3";"1";"4";"0";"0";"null";"null";"0.0";"1.0";"0.75";"0.25";"1.0";"0.0";"0.0";"1"
"2460705";"Kaimoto";"24";"0";"24";"0";"24";"20";"4";"4";"null";"null";"0.0";"1.0";"0.0";"1.0";"0.8333333333333334";"0.16666666666666666";"0.16666666666666666";"1"
"2194470";"Suresh Chand";"2";"1";"1";"1";"1";"2";"0";"0";"null";"null";"0.5";"0.5";"0.5";"0.5";"1.0";"0.0";"0.0";"1"
"4164664";"Shyam Sundar Prasad Yadav";"10";"0";"10";"0";"10";"2";"8";"0";"null";"null";"0.0";"1.0";"0.0";"1.0";"0.2";"0.8";"0.0";"1"
"4164663";"Rozeenakunwar";"3";"2";"1";"2";"1";"1";"2";"1";"null";"null";"0.6666666666666666";"0.3333333333333333";"0.6666666666666666";"0.3333333333333333";"0.3333333333333333";"0.6666666666666666";"0.3333333333333333";"3"
"3021860";"streetinformer";"10";"5";"5";"9";"1";"8";"2";"2";"null";"null";"0.5";"0.5";"0.9";"0.1";"0.8";"0.2";"0.2";"4"
"1965078";"NabinaNakano";"1";"0";"1";"0";"1";"1";"0";"0";"null";"null";"0.0";"1.0";"0.0";"1.0";"1.0";"0.0";"0.0";"1"
"4164659";"nikeecha";"6";"0";"6";"0";"6";"2";"4";"0";"null";"null";"0.0";"1.0";"0.0";"1.0";"0.3333333333333333";"0.6666666666666666";"0.0";"3"
"2980897";"apeskin";"2";"1";"1";"1";"1";"1";"1";"0";"null";"null";"0.5";"0.5";"0.5";"0.5";"0.5";"0.5";"0.0";"2"
"2878523";"BeeDoe";"21";"20";"1";"20";"1";"21";"0";"0";"null";"null";"0.9523809523809523";"0.047619047619047616";"0.9523809523809523";"0.047619047619047616";"1.0";"0.0";"0.0";"1"
"1965068";"Wisdom Pandey";"39";"24";"15";"38";"1";"23";"16";"6";"null";"null";"0.6153846153846154";"0.38461538461538464";"0.9743589743589743";"0.02564102564102564";"0.5897435897435898";"0.41025641025641024";"0.15384615384615385";"12"
"4164652";"tandukarpratibha";"67";"0";"67";"0";"67";"57";"10";"3";"null";"null";"0.0";"1.0";"0.0";"1.0";"0.8507462686567164";"0.14925373134328357";"0.04477611940298507";"3"
"4938847";"DTS MOBILE MAINTENANCE";"2";"1";"1";"1";"1";"1";"1";"0";"null";"null";"0.5";"0.5";"0.5";"0.5";"0.5";"0.5";"0.0";"1"
"4164650";"BMTharu";"21";"0";"21";"0";"21";"16";"5";"5";"null";"null";"0.0";"1.0";"0.0";"1.0";"0.7619047619047619";"0.23809523809523808";"0.23809523809523808";"11"
"2870334";"rdyess41";"3";"0";"3";"2";"1";"3";"0";"0";"null";"null";"0.0";"1.0";"0.6666666666666666";"0.3333333333333333";"1.0";"0.0";"0.0";"1"
"2866238";"Rachel Az";"19";"0";"19";"18";"1";"19";"0";"0";"null";"null";"0.0";"1.0";"0.9473684210526315";"0.05263157894736842";"1.0";"0.0";"0.0";"1"
"203798";"rouch";"1";"0";"1";"0";"1";"1";"0";"0";"null";"null";"0.0";"1.0";"0.0";"1.0";"1.0";"0.0";"0.0";"1"
"2878525";"adefm";"18";"17";"1";"17";"1";"18";"0";"0";"null";"null";"0.9444444444444444";"0.05555555555555555";"0.9444444444444444";"0.05555555555555555";"1.0";"0.0";"0.0";"3"
"2874418";"Cornelia Tan";"23";"0";"23";"22";"1";"23";"0";"0";"null";"null";"0.0";"1.0";"0.9565217391304348";"0.043478260869565216";"1.0";"0.0";"0.0";"1"
"2866226";"marillanov";"489";"0";"489";"488";"1";"465";"24";"24";"null";"null";"0.0";"1.0";"0.9979550102249489";"0.002044989775051125";"0.950920245398773";"0.049079754601226995";"0.049079754601226995";"5"
"3005495";"PrabNtmp";"21";"20";"1";"20";"1";"21";"0";"0";"null";"null";"0.9523809523809523";"0.047619047619047616";"0.9523809523809523";"0.047619047619047616";"1.0";"0.0";"0.0";"1"
"4164643";"sukritpant";"44";"5";"39";"5";"39";"41";"3";"0";"null";"null";"0.11363636363636363";"0.8863636363636364";"0.11363636363636363";"0.8863636363636364";"0.9318181818181818";"0.06818181818181818";"0.0";"2"
"2194495";"Saurav777";"8";"7";"1";"7";"1";"2";"6";"2";"null";"null";"0.875";"0.125";"0.875";"0.125";"0.25";"0.75";"0.25";"6"
"4570202";"Suman Sharma";"3";"2";"1";"2";"1";"3";"0";"0";"null";"null";"0.6666666666666666";"0.3333333333333333";"0.6666666666666666";"0.3333333333333333";"1.0";"0.0";"0.0";"2"
"4164638";"Ayog Basnyat";"9";"0";"9";"0";"9";"8";"1";"0";"null";"null";"0.0";"1.0";"0.0";"1.0";"0.8888888888888888";"0.1111111111111111";"0.0";"2"
"1965108";"sac_tt";"7";"0";"7";"6";"1";"6";"1";"0";"null";"null";"0.0";"1.0";"0.8571428571428571";"0.14285714285714285";"0.8571428571428571";"0.14285714285714285";"0.0";"3"
"4324458";"sharna maharjan";"1";"0";"1";"0";"1";"1";"0";"0";"null";"null";"0.0";"1.0";"0.0";"1.0";"1.0";"0.0";"0.0";"1"
"4025366";"raz shaked";"1";"0";"1";"0";"1";"1";"0";"0";"null";"null";"0.0";"1.0";"0.0";"1.0";"1.0";"0.0";"0.0";"1"
"4164626";"Deepak232";"7";"5";"2";"5";"2";"7";"0";"0";"null";"null";"0.7142857142857143";"0.2857142857142857";"0.7142857142857143";"0.2857142857142857";"1.0";"0.0";"0.0";"3"
"2554889";"Atlanticnepal";"4";"3";"1";"3";"1";"3";"1";"1";"null";"null";"0.75";"0.25";"0.75";"0.25";"0.75";"0.25";"0.25";"2"
"4766840";"‫עמית אבקסיס‬‎";"1";"0";"1";"0";"1";"1";"0";"0";"null";"null";"0.0";"1.0";"0.0";"1.0";"1.0";"0.0";"0.0";"1"
"4164623";"Nishan007";"44";"6";"38";"6";"38";"39";"5";"0";"null";"null";"0.13636363636363635";"0.8636363636363636";"0.13636363636363635";"0.8636363636363636";"0.8863636363636364";"0.11363636363636363";"0.0";"4"
"2194448";"DSP21";"23";"22";"1";"22";"1";"23";"0";"0";"null";"null";"0.9565217391304348";"0.043478260869565216";"0.9565217391304348";"0.043478260869565216";"1.0";"0.0";"0.0";"6"
"4361334";"Anish Kc";"1";"0";"1";"0";"1";"1";"0";"0";"null";"null";"0.0";"1.0";"0.0";"1.0";"1.0";"0.0";"0.0";"1"
"1965094";"Nishakiran";"21";"20";"1";"20";"1";"13";"8";"0";"null";"null";"0.9523809523809523";"0.047619047619047616";"0.9523809523809523";"0.047619047619047616";"0.6190476190476191";"0.38095238095238093";"0.0";"9"
"351294";"AnishJoshi";"28";"21";"7";"27";"1";"19";"9";"6";"null";"null";"0.75";"0.25";"0.9642857142857143";"0.03571428571428571";"0.6785714285714286";"0.32142857142857145";"0.21428571428571427";"3"
"2227229";"perry22sl";"169";"27";"142";"136";"33";"76";"93";"64";"null";"null";"0.15976331360946747";"0.8402366863905325";"0.8047337278106509";"0.1952662721893491";"0.44970414201183434";"0.5502958579881657";"0.378698224852071";"33"
"2882582";"Duke123";"6";"5";"1";"5";"1";"6";"0";"0";"null";"null";"0.8333333333333334";"0.16666666666666666";"0.8333333333333334";"0.16666666666666666";"1.0";"0.0";"0.0";"1"
"1674279";"manish dangol";"8";"1";"7";"6";"2";"4";"4";"4";"null";"null";"0.125";"0.875";"0.75";"0.25";"0.5";"0.5";"0.5";"4"
"2878485";"ritaw";"49";"48";"1";"48";"1";"49";"0";"0";"null";"null";"0.9795918367346939";"0.02040816326530612";"0.9795918367346939";"0.02040816326530612";"1.0";"0.0";"0.0";"2"
"2276381";"Rajat Agrawal";"10";"0";"10";"9";"1";"5";"5";"1";"null";"null";"0.0";"1.0";"0.9";"0.1";"0.5";"0.5";"0.1";"1"
"474183";"ratrun";"97";"2";"95";"95";"2";"0";"97";"80";"null";"null";"0.020618556701030927";"0.979381443298969";"0.979381443298969";"0.020618556701030927";"0.0";"1.0";"0.8247422680412371";"11"
"64578";"Serpens";"9";"3";"6";"7";"2";"0";"9";"0";"null";"null";"0.3333333333333333";"0.6666666666666666";"0.7777777777777778";"0.2222222222222222";"0.0";"1.0";"0.0";"5"
"2890856";"Trọng Tùng Nguyễn";"48";"0";"48";"47";"1";"36";"12";"0";"null";"null";"0.0";"1.0";"0.9791666666666666";"0.020833333333333332";"0.75";"0.25";"0.0";"7"
"2874466";"mgsoto";"53";"52";"1";"52";"1";"53";"0";"0";"null";"null";"0.9811320754716981";"0.018867924528301886";"0.9811320754716981";"0.018867924528301886";"1.0";"0.0";"0.0";"2"
"2538604";"Nayan1";"1";"0";"1";"0";"1";"1";"0";"0";"null";"null";"0.0";"1.0";"0.0";"1.0";"1.0";"0.0";"0.0";"1"
"1723478";"ntat";"235";"143";"92";"234";"1";"162";"73";"0";"null";"null";"0.6085106382978723";"0.39148936170212767";"0.9957446808510638";"0.00425531914893617";"0.6893617021276596";"0.31063829787234043";"0.0";"6"
"4140145";"Axon Shrestha";"1";"0";"1";"0";"1";"1";"0";"0";"null";"null";"0.0";"1.0";"0.0";"1.0";"1.0";"0.0";"0.0";"1"
"384084";"Kostik";"246";"243";"3";"195";"51";"12";"234";"187";"null";"null";"0.9878048780487805";"0.012195121951219513";"0.7926829268292683";"0.2073170731707317";"0.04878048780487805";"0.9512195121951219";"0.7601626016260162";"10"
"2792568";"meowsiopao";"42";"41";"1";"41";"1";"42";"0";"0";"null";"null";"0.9761904761904762";"0.023809523809523808";"0.9761904761904762";"0.023809523809523808";"1.0";"0.0";"0.0";"2"
"4160618";"SD SHakya";"1";"0";"1";"0";"1";"1";"0";"0";"null";"null";"0.0";"1.0";"0.0";"1.0";"1.0";"0.0";"0.0";"1"
"2899065";"Shreya B";"6";"0";"6";"5";"1";"6";"0";"0";"null";"null";"0.0";"1.0";"0.8333333333333334";"0.16666666666666666";"1.0";"0.0";"0.0";"1"
"195668";"feiming";"3";"2";"1";"2";"1";"3";"0";"0";"null";"null";"0.6666666666666666";"0.3333333333333333";"0.6666666666666666";"0.3333333333333333";"1.0";"0.0";"0.0";"1"
"2878589";"Ajay Shrestha";"22";"21";"1";"21";"1";"22";"0";"0";"null";"null";"0.9545454545454546";"0.045454545454545456";"0.9545454545454546";"0.045454545454545456";"1.0";"0.0";"0.0";"1"
"3349604";"Ad_OSM Contributor";"350";"197";"153";"0";"350";"264";"86";"80";"null";"null";"0.5628571428571428";"0.43714285714285717";"0.0";"1.0";"0.7542857142857143";"0.24571428571428572";"0.22857142857142856";"4"
"4803614";"nonstickst";"1";"0";"1";"0";"1";"1";"0";"0";"null";"null";"0.0";"1.0";"0.0";"1.0";"1.0";"0.0";"0.0";"1"
"4627473";"Max von Hippel";"1";"0";"1";"0";"1";"0";"1";"0";"null";"null";"0.0";"1.0";"0.0";"1.0";"0.0";"1.0";"0.0";"1"
"4824081";"subash dhital";"1";"0";"1";"0";"1";"1";"0";"0";"null";"null";"0.0";"1.0";"0.0";"1.0";"1.0";"0.0";"0.0";"1"
"4574238";"Kirtipur Ladies Hostel";"3";"2";"1";"0";"3";"3";"0";"0";"null";"null";"0.6666666666666666";"0.3333333333333333";"0.0";"1.0";"1.0";"0.0";"0.0";"2"
"4594712";"Kevin2047";"3";"2";"1";"1";"2";"3";"0";"0";"null";"null";"0.6666666666666666";"0.3333333333333333";"0.3333333333333333";"0.6666666666666666";"1.0";"0.0";"0.0";"3"
"1485896";"johns1";"191";"0";"191";"190";"1";"186";"5";"5";"null";"null";"0.0";"1.0";"0.9947643979057592";"0.005235602094240838";"0.9738219895287958";"0.02617801047120419";"0.02617801047120419";"4"
"4832279";"debjani paul";"1";"0";"1";"0";"1";"0";"1";"0";"null";"null";"0.0";"1.0";"0.0";"1.0";"0.0";"1.0";"0.0";"1"
"2870388";"marie klaahsen";"75";"55";"20";"74";"1";"74";"1";"0";"null";"null";"0.7333333333333333";"0.26666666666666666";"0.9866666666666667";"0.013333333333333334";"0.9866666666666667";"0.013333333333333334";"0.0";"6"
"2878537";"Sianski";"821";"473";"348";"820";"1";"811";"10";"0";"null";"null";"0.5761266747868453";"0.4238733252131547";"0.9987819732034104";"0.001218026796589525";"0.9878197320341048";"0.012180267965895249";"0.0";"3"
"60519";"Vautour";"112";"0";"112";"111";"1";"50";"62";"14";"null";"null";"0.0";"1.0";"0.9910714285714286";"0.008928571428571428";"0.44642857142857145";"0.5535714285714286";"0.125";"2"
"576633";"nily";"205";"0";"205";"0";"205";"72";"133";"2";"null";"null";"0.0";"1.0";"0.0";"1.0";"0.35121951219512193";"0.6487804878048781";"0.00975609756097561";"2"
"1227873";"Bibek Neupane";"51";"0";"51";"50";"1";"45";"6";"4";"null";"null";"0.0";"1.0";"0.9803921568627451";"0.0196078431372549";"0.8823529411764706";"0.11764705882352941";"0.0784313725490196";"2"
"3316804";"ashkan55";"2";"1";"1";"0";"2";"2";"0";"0";"null";"null";"0.5";"0.5";"0.0";"1.0";"1.0";"0.0";"0.0";"1"
"3873869";"Sujan_Dahal";"6";"5";"1";"5";"1";"6";"0";"0";"null";"null";"0.8333333333333334";"0.16666666666666666";"0.8333333333333334";"0.16666666666666666";"1.0";"0.0";"0.0";"1"
"691314";"H@mlet";"33";"0";"33";"32";"1";"30";"3";"0";"null";"null";"0.0";"1.0";"0.9696969696969697";"0.030303030303030304";"0.9090909090909091";"0.09090909090909091";"0.0";"2"
"3591245";"Nandito95";"82";"0";"82";"46";"36";"82";"0";"0";"null";"null";"0.0";"1.0";"0.5609756097560976";"0.43902439024390244";"1.0";"0.0";"0.0";"5"
"4365373";"Bikeshk";"2";"1";"1";"1";"1";"2";"0";"0";"null";"null";"0.5";"0.5";"0.5";"0.5";"1.0";"0.0";"0.0";"2"
"2866260";"darkbox168";"76";"0";"76";"75";"1";"76";"0";"0";"null";"null";"0.0";"1.0";"0.9868421052631579";"0.013157894736842105";"1.0";"0.0";"0.0";"3"
"2866344";"cheetos";"794";"0";"794";"793";"1";"786";"8";"0";"null";"null";"0.0";"1.0";"0.9987405541561712";"0.0012594458438287153";"0.9899244332493703";"0.010075566750629723";"0.0";"171"
"2862252";"JeremiN";"269";"0";"269";"268";"1";"242";"27";"15";"null";"null";"0.0";"1.0";"0.9962825278810409";"0.0037174721189591076";"0.8996282527881041";"0.10037174721189591";"0.055762081784386616";"9"
"4967628";"saurav shrestha";"1";"0";"1";"0";"1";"1";"0";"0";"null";"null";"0.0";"1.0";"0.0";"1.0";"1.0";"0.0";"0.0";"1"
"2870435";"nconstantino";"166";"0";"166";"165";"1";"165";"1";"1";"null";"null";"0.0";"1.0";"0.9939759036144579";"0.006024096385542169";"0.9939759036144579";"0.006024096385542169";"0.006024096385542169";"31"
"3108006";"Samyem Tuladhar";"4";"3";"1";"3";"1";"1";"3";"0";"null";"null";"0.75";"0.25";"0.75";"0.25";"0.25";"0.75";"0.0";"1"
"3209";"fil";"55";"0";"55";"54";"1";"55";"0";"0";"null";"null";"0.0";"1.0";"0.9818181818181818";"0.01818181818181818";"1.0";"0.0";"0.0";"2"
"2866338";"GHoeft";"127";"0";"127";"126";"1";"127";"0";"0";"null";"null";"0.0";"1.0";"0.9921259842519685";"0.007874015748031496";"1.0";"0.0";"0.0";"31"
"4578511";"Multi Printing Prrss";"3";"0";"3";"2";"1";"1";"2";"0";"null";"null";"0.0";"1.0";"0.6666666666666666";"0.3333333333333333";"0.3333333333333333";"0.6666666666666666";"0.0";"2"
"2882721";"Drichey97";"8";"7";"1";"7";"1";"8";"0";"0";"null";"null";"0.875";"0.125";"0.875";"0.125";"1.0";"0.0";"0.0";"1"
"3828913";"Noyel";"4";"2";"2";"3";"1";"4";"0";"0";"null";"null";"0.5";"0.5";"0.75";"0.25";"1.0";"0.0";"0.0";"3"
"212111";"okilimu";"490";"0";"490";"489";"1";"478";"12";"9";"null";"null";"0.0";"1.0";"0.9979591836734694";"0.0020408163265306124";"0.9755102040816327";"0.024489795918367346";"0.018367346938775512";"3"
"2866342";"CassiaMCS";"24";"0";"24";"23";"1";"20";"4";"4";"null";"null";"0.0";"1.0";"0.9583333333333334";"0.041666666666666664";"0.8333333333333334";"0.16666666666666666";"0.16666666666666666";"4"
"2866341";"Andrew Goodman";"136";"0";"136";"135";"1";"136";"0";"0";"null";"null";"0.0";"1.0";"0.9926470588235294";"0.007352941176470588";"1.0";"0.0";"0.0";"30"
"5053634";"Kaurska Seven";"1";"0";"1";"0";"1";"1";"0";"0";"null";"null";"0.0";"1.0";"0.0";"1.0";"1.0";"0.0";"0.0";"1"
"2866340";"14riesma";"103";"0";"103";"102";"1";"103";"0";"0";"null";"null";"0.0";"1.0";"0.9902912621359223";"0.009708737864077669";"1.0";"0.0";"0.0";"2"
"2878648";"Mamidipalli Venkatesh";"32";"31";"1";"31";"1";"24";"8";"8";"null";"null";"0.96875";"0.03125";"0.96875";"0.03125";"0.75";"0.25";"0.25";"6"
"2874552";"Karma Jinpa Palden Cleveland";"5";"3";"2";"4";"1";"3";"2";"0";"null";"null";"0.6";"0.4";"0.8";"0.2";"0.6";"0.4";"0.0";"4"
"3964072";"FamilyPeace House Kathmandu";"3";"1";"2";"0";"3";"2";"1";"0";"null";"null";"0.3333333333333333";"0.6666666666666666";"0.0";"1.0";"0.6666666666666666";"0.3333333333333333";"0.0";"2"
"68756";"brianadr";"4";"0";"4";"3";"1";"4";"0";"0";"null";"null";"0.0";"1.0";"0.75";"0.25";"1.0";"0.0";"0.0";"1"
"2866354";"cashm083";"144";"0";"144";"143";"1";"126";"18";"18";"null";"null";"0.0";"1.0";"0.9930555555555556";"0.006944444444444444";"0.875";"0.125";"0.125";"27"
"2866352";"dudyc007";"101";"0";"101";"100";"1";"100";"1";"0";"null";"null";"0.0";"1.0";"0.9900990099009901";"0.009900990099009901";"0.9900990099009901";"0.009900990099009901";"0.0";"10"
"4725972";"mobile care";"2";"0";"2";"0";"2";"2";"0";"0";"null";"null";"0.0";"1.0";"0.0";"1.0";"1.0";"0.0";"0.0";"1"
"2866356";"HayleySevers";"273";"0";"273";"272";"1";"273";"0";"0";"null";"null";"0.0";"1.0";"0.9963369963369964";"0.003663003663003663";"1.0";"0.0";"0.0";"61"
"1137842";"sujanrajjoshi";"7";"0";"7";"6";"1";"7";"0";"0";"null";"null";"0.0";"1.0";"0.8571428571428571";"0.14285714285714285";"1.0";"0.0";"0.0";"1"
"4521196";"Sajanmaharjan";"9";"8";"1";"0";"9";"9";"0";"0";"null";"null";"0.8888888888888888";"0.1111111111111111";"0.0";"1.0";"1.0";"0.0";"0.0";"1"
"2866304";"Boram Lee jung";"1116";"0";"1116";"1115";"1";"1110";"6";"5";"null";"null";"0.0";"1.0";"0.9991039426523297";"8.960573476702509E-4";"0.9946236559139785";"0.005376344086021506";"0.004480286738351254";"16"
"4455656";"Nubivagus";"5";"4";"1";"4";"1";"3";"2";"0";"null";"null";"0.8";"0.2";"0.8";"0.2";"0.6";"0.4";"0.0";"5"
"3050629";"Icicles Adventure Trek";"1";"0";"1";"0";"1";"1";"0";"0";"null";"null";"0.0";"1.0";"0.0";"1.0";"1.0";"0.0";"0.0";"1"
"2899072";"Catherine888";"3";"0";"3";"2";"1";"0";"3";"1";"null";"null";"0.0";"1.0";"0.6666666666666666";"0.3333333333333333";"0.0";"1.0";"0.3333333333333333";"1"
"1068220";"Helina";"2084";"1428";"656";"1700";"384";"1014";"1070";"237";"null";"null";"0.6852207293666027";"0.31477927063339733";"0.8157389635316699";"0.18426103646833014";"0.4865642994241843";"0.5134357005758158";"0.11372360844529751";"41"
"2899073";"Ian Madrista";"3";"0";"3";"2";"1";"0";"3";"0";"null";"null";"0.0";"1.0";"0.6666666666666666";"0.3333333333333333";"0.0";"1.0";"0.0";"1"
"2899074";"sudeshana shakya";"2";"0";"2";"1";"1";"1";"1";"0";"null";"null";"0.0";"1.0";"0.5";"0.5";"0.5";"0.5";"0.0";"2"
"2878619";"wangko";"289";"288";"1";"288";"1";"276";"13";"12";"null";"null";"0.9965397923875432";"0.0034602076124567475";"0.9965397923875432";"0.0034602076124567475";"0.9550173010380623";"0.04498269896193772";"0.04152249134948097";"1"
"2866330";"watts135";"84";"0";"84";"83";"1";"80";"4";"0";"null";"null";"0.0";"1.0";"0.9880952380952381";"0.011904761904761904";"0.9523809523809523";"0.047619047619047616";"0.0";"16"
"470196";"wipu";"8";"7";"1";"7";"1";"8";"0";"0";"null";"null";"0.875";"0.125";"0.875";"0.125";"1.0";"0.0";"0.0";"1"
"2866335";"Betsy Johannsen";"45";"0";"45";"44";"1";"44";"1";"0";"null";"null";"0.0";"1.0";"0.9777777777777777";"0.022222222222222223";"0.9777777777777777";"0.022222222222222223";"0.0";"9"
"2866332";"crass009";"83";"0";"83";"82";"1";"83";"0";"0";"null";"null";"0.0";"1.0";"0.9879518072289156";"0.012048192771084338";"1.0";"0.0";"0.0";"16"
"3112087";"Ro Sun";"32";"17";"15";"31";"1";"7";"25";"0";"null";"null";"0.53125";"0.46875";"0.96875";"0.03125";"0.21875";"0.78125";"0.0";"3"
"2866323";"moriasloan";"41";"0";"41";"40";"1";"41";"0";"0";"null";"null";"0.0";"1.0";"0.975609756097561";"0.024390243902439025";"1.0";"0.0";"0.0";"1"
"224440";"Syl";"20";"0";"20";"19";"1";"0";"20";"19";"null";"null";"0.0";"1.0";"0.95";"0.05";"0.0";"1.0";"0.95";"3"
"2878614";"Sounak Kundu";"20";"19";"1";"19";"1";"20";"0";"0";"null";"null";"0.95";"0.05";"0.95";"0.05";"1.0";"0.0";"0.0";"3"
"3271920";"prjwl";"1";"0";"1";"0";"1";"0";"1";"0";"null";"null";"0.0";"1.0";"0.0";"1.0";"0.0";"1.0";"0.0";"1"
"4799627";"Shrestha Store";"1";"0";"1";"0";"1";"1";"0";"0";"null";"null";"0.0";"1.0";"0.0";"1.0";"1.0";"0.0";"0.0";"1"
"2940136";"Sujanrai";"4";"3";"1";"3";"1";"4";"0";"0";"null";"null";"0.75";"0.25";"0.75";"0.25";"1.0";"0.0";"0.0";"2"
"2292967";"Milan Maharjan";"2";"1";"1";"1";"1";"1";"1";"0";"null";"null";"0.5";"0.5";"0.5";"0.5";"0.5";"0.5";"0.0";"2"
"3153142";"Prajol";"24";"4";"20";"0";"24";"7";"17";"1";"null";"null";"0.16666666666666666";"0.8333333333333334";"0.0";"1.0";"0.2916666666666667";"0.7083333333333334";"0.041666666666666664";"2"
"2890986";"Birendra Guragain";"1";"0";"1";"0";"1";"1";"0";"0";"null";"null";"0.0";"1.0";"0.0";"1.0";"1.0";"0.0";"0.0";"1"
"2870509";"arinaermakova";"76";"0";"76";"75";"1";"56";"20";"0";"null";"null";"0.0";"1.0";"0.9868421052631579";"0.013157894736842105";"0.7368421052631579";"0.2631578947368421";"0.0";"1"
"3271926";"gopal nyaupane";"5";"0";"5";"4";"1";"4";"1";"0";"null";"null";"0.0";"1.0";"0.8";"0.2";"0.8";"0.2";"0.0";"1"
"4910210";"Rohit Thapa";"2";"0";"2";"1";"1";"1";"1";"0";"null";"null";"0.0";"1.0";"0.5";"0.5";"0.5";"0.5";"0.0";"1"
"56524";"beetletun";"1";"0";"1";"0";"1";"1";"0";"0";"null";"null";"0.0";"1.0";"0.0";"1.0";"1.0";"0.0";"0.0";"1"
"3271905";"illusionboi";"21";"0";"21";"20";"1";"20";"1";"0";"null";"null";"0.0";"1.0";"0.9523809523809523";"0.047619047619047616";"0.9523809523809523";"0.047619047619047616";"0.0";"1"
"4410512";"Manish Bista";"1";"0";"1";"0";"1";"1";"0";"0";"null";"null";"0.0";"1.0";"0.0";"1.0";"1.0";"0.0";"0.0";"1"
"3271908";"4nova";"42";"0";"42";"41";"1";"25";"17";"10";"null";"null";"0.0";"1.0";"0.9761904761904762";"0.023809523809523808";"0.5952380952380952";"0.40476190476190477";"0.23809523809523808";"4"
"3271913";"ashmi432";"5";"0";"5";"4";"1";"5";"0";"0";"null";"null";"0.0";"1.0";"0.8";"0.2";"1.0";"0.0";"0.0";"1"
"4807827";"chalie42";"5";"1";"4";"4";"1";"5";"0";"0";"null";"null";"0.2";"0.8";"0.8";"0.2";"1.0";"0.0";"0.0";"2"
"2878666";"stegalfa";"602";"601";"1";"601";"1";"528";"74";"74";"null";"null";"0.9983388704318937";"0.0016611295681063123";"0.9983388704318937";"0.0016611295681063123";"0.8770764119601329";"0.12292358803986711";"0.12292358803986711";"23"
"85218";"Aleks-Berlin";"82";"81";"1";"81";"1";"0";"82";"0";"null";"null";"0.9878048780487805";"0.012195121951219513";"0.9878048780487805";"0.012195121951219513";"0.0";"1.0";"0.0";"4"
"3787996";"Yadab Prasad Guni";"9";"6";"3";"7";"2";"8";"1";"0";"null";"null";"0.6666666666666666";"0.3333333333333333";"0.7777777777777778";"0.2222222222222222";"0.8888888888888888";"0.1111111111111111";"0.0";"7"
"4971694";"Hari Bhattarai";"2";"0";"2";"1";"1";"2";"0";"0";"null";"null";"0.0";"1.0";"0.5";"0.5";"1.0";"0.0";"0.0";"1"
"2866380";"Letizia Garzoli";"754";"0";"754";"753";"1";"753";"1";"0";"null";"null";"0.0";"1.0";"0.9986737400530504";"0.001326259946949602";"0.9986737400530504";"0.001326259946949602";"0.0";"18"
"1551591";"Randoua";"3";"2";"1";"1";"2";"2";"1";"0";"null";"null";"0.6666666666666666";"0.3333333333333333";"0.3333333333333333";"0.6666666666666666";"0.6666666666666666";"0.3333333333333333";"0.0";"3"
"2866393";"BobbyDai";"17";"0";"17";"16";"1";"12";"5";"0";"null";"null";"0.0";"1.0";"0.9411764705882353";"0.058823529411764705";"0.7058823529411765";"0.29411764705882354";"0.0";"1"
"2731217";"GoUtes!";"32";"0";"32";"31";"1";"0";"32";"32";"null";"null";"0.0";"1.0";"0.96875";"0.03125";"0.0";"1.0";"1.0";"4"
"1535212";"danbjoseph";"94";"0";"94";"93";"1";"45";"49";"14";"null";"null";"0.0";"1.0";"0.9893617021276596";"0.010638297872340425";"0.4787234042553192";"0.5212765957446809";"0.14893617021276595";"2"
"4848821";"neymar neupane";"1";"0";"1";"0";"1";"1";"0";"0";"null";"null";"0.0";"1.0";"0.0";"1.0";"1.0";"0.0";"0.0";"1"
"4951220";"Nil Peace";"1";"0";"1";"0";"1";"1";"0";"0";"null";"null";"0.0";"1.0";"0.0";"1.0";"1.0";"0.0";"0.0";"1"
"2870571";"Rajee";"103";"102";"1";"102";"1";"103";"0";"0";"null";"null";"0.9902912621359223";"0.009708737864077669";"0.9902912621359223";"0.009708737864077669";"1.0";"0.0";"0.0";"25"
"1920286";"Kcdipendra";"2";"1";"1";"1";"1";"2";"0";"0";"null";"null";"0.5";"0.5";"0.5";"0.5";"1.0";"0.0";"0.0";"2"
"118021";"maggot27";"21";"0";"21";"20";"1";"0";"21";"18";"null";"null";"0.0";"1.0";"0.9523809523809523";"0.047619047619047616";"0.0";"1.0";"0.8571428571428571";"6"
"3910975";"PRABIN PRAJAPATI";"3";"1";"2";"1";"2";"2";"1";"0";"null";"null";"0.3333333333333333";"0.6666666666666666";"0.3333333333333333";"0.6666666666666666";"0.6666666666666666";"0.3333333333333333";"0.0";"3"
"4836684";"Sanjib Thapa";"1";"0";"1";"0";"1";"1";"0";"0";"null";"null";"0.0";"1.0";"0.0";"1.0";"1.0";"0.0";"0.0";"1"
"2047256";"じょーり";"37";"7";"30";"36";"1";"37";"0";"0";"null";"null";"0.1891891891891892";"0.8108108108108109";"0.972972972972973";"0.02702702702702703";"1.0";"0.0";"0.0";"5"
"2923813";"kobiwa";"105";"102";"3";"104";"1";"103";"2";"0";"null";"null";"0.9714285714285714";"0.02857142857142857";"0.9904761904761905";"0.009523809523809525";"0.9809523809523809";"0.01904761904761905";"0.0";"5"
"1871122";"dewla";"51";"0";"51";"50";"1";"51";"0";"0";"null";"null";"0.0";"1.0";"0.9803921568627451";"0.0196078431372549";"1.0";"0.0";"0.0";"1"
"2960701";"knyacky";"841";"637";"204";"840";"1";"563";"278";"39";"null";"null";"0.7574316290130797";"0.24256837098692033";"0.9988109393579072";"0.0011890606420927466";"0.6694411414982164";"0.33055885850178357";"0.04637336504161712";"20"
"478484";"epicureanism";"23";"19";"4";"0";"23";"23";"0";"0";"null";"null";"0.8260869565217391";"0.17391304347826086";"0.0";"1.0";"1.0";"0.0";"0.0";"2"
"56597";"Oberaffe";"104";"0";"104";"103";"1";"98";"6";"4";"null";"null";"0.0";"1.0";"0.9903846153846154";"0.009615384615384616";"0.9423076923076923";"0.057692307692307696";"0.038461538461538464";"2"
"2870589";"HOT_Helper_0002";"3042";"2969";"73";"56";"2986";"3040";"2";"0";"null";"null";"0.9760026298487837";"0.023997370151216304";"0.018408941485864562";"0.9815910585141354";"0.9993425378040762";"6.574621959237344E-4";"0.0";"71"
"4009259";"Rabin Baidhya";"2";"0";"2";"1";"1";"2";"0";"0";"null";"null";"0.0";"1.0";"0.5";"0.5";"1.0";"0.0";"0.0";"1"
"3804449";"Yoshiatsu";"11";"10";"1";"10";"1";"4";"7";"0";"null";"null";"0.9090909090909091";"0.09090909090909091";"0.9090909090909091";"0.09090909090909091";"0.36363636363636365";"0.6363636363636364";"0.0";"1"
"2870531";"Jake Wegmann";"5";"0";"5";"4";"1";"5";"0";"0";"null";"null";"0.0";"1.0";"0.8";"0.2";"1.0";"0.0";"0.0";"1"
"2866432";"goodr119";"8";"0";"8";"7";"1";"8";"0";"0";"null";"null";"0.0";"1.0";"0.875";"0.125";"1.0";"0.0";"0.0";"2"
"2428171";"prokyon";"62";"0";"62";"61";"1";"62";"0";"0";"null";"null";"0.0";"1.0";"0.9838709677419355";"0.016129032258064516";"1.0";"0.0";"0.0";"5"
"4447605";"Aadesh Baniya";"7";"1";"6";"3";"4";"7";"0";"0";"null";"null";"0.14285714285714285";"0.8571428571428571";"0.42857142857142855";"0.5714285714285714";"1.0";"0.0";"0.0";"5"
"2882845";"M Farley";"4";"3";"1";"3";"1";"4";"0";"0";"null";"null";"0.75";"0.25";"0.75";"0.25";"1.0";"0.0";"0.0";"1"
"4382069";"Mukesh Deo";"1";"0";"1";"0";"1";"1";"0";"0";"null";"null";"0.0";"1.0";"0.0";"1.0";"1.0";"0.0";"0.0";"1"
"2907415";"barma754";"191";"0";"191";"190";"1";"191";"0";"0";"null";"null";"0.0";"1.0";"0.9947643979057592";"0.005235602094240838";"1.0";"0.0";"0.0";"18"
"77114";"LLAQWA";"240";"0";"240";"239";"1";"231";"9";"0";"null";"null";"0.0";"1.0";"0.9958333333333333";"0.004166666666666667";"0.9625";"0.0375";"0.0";"3"
"593205";"msdess";"3";"0";"3";"0";"3";"0";"3";"0";"null";"null";"0.0";"1.0";"0.0";"1.0";"0.0";"1.0";"0.0";"1"
"3489033";"Adrian Laurenzi";"1";"0";"1";"0";"1";"1";"0";"0";"null";"null";"0.0";"1.0";"0.0";"1.0";"1.0";"0.0";"0.0";"1"
"1948960";"sawbin15";"100";"1";"99";"0";"100";"67";"33";"24";"null";"null";"0.01";"0.99";"0.0";"1.0";"0.67";"0.33";"0.24";"19"
"2518299";"ARS panta";"24";"3";"21";"0";"24";"22";"2";"1";"null";"null";"0.125";"0.875";"0.0";"1.0";"0.9166666666666666";"0.08333333333333333";"0.041666666666666664";"3"
"85314";"Samusz";"708";"707";"1";"707";"1";"620";"88";"8";"null";"null";"0.998587570621469";"0.0014124293785310734";"0.998587570621469";"0.0014124293785310734";"0.8757062146892656";"0.12429378531073447";"0.011299435028248588";"2"
"2870638";"Paulo Patire";"72";"0";"72";"71";"1";"72";"0";"0";"null";"null";"0.0";"1.0";"0.9861111111111112";"0.013888888888888888";"1.0";"0.0";"0.0";"1"
"556366";"myneur";"2";"0";"2";"0";"2";"2";"0";"0";"null";"null";"0.0";"1.0";"0.0";"1.0";"1.0";"0.0";"0.0";"1"
"2862434";"rajhawaii";"20";"0";"20";"19";"1";"20";"0";"0";"null";"null";"0.0";"1.0";"0.95";"0.05";"1.0";"0.0";"0.0";"2"
"2874727";"Ashis Kharel";"7";"6";"1";"6";"1";"1";"6";"2";"null";"null";"0.8571428571428571";"0.14285714285714285";"0.8571428571428571";"0.14285714285714285";"0.14285714285714285";"0.8571428571428571";"0.2857142857142857";"1"
"1998160";"Chrisitan";"99";"95";"4";"0";"99";"99";"0";"0";"null";"null";"0.9595959595959596";"0.04040404040404041";"0.0";"1.0";"1.0";"0.0";"0.0";"2"
"2874746";"Karan Kunwar";"16";"7";"9";"15";"1";"16";"0";"0";"null";"null";"0.4375";"0.5625";"0.9375";"0.0625";"1.0";"0.0";"0.0";"2"
"3808620";"Abeey Paudel";"3";"0";"3";"2";"1";"3";"0";"0";"null";"null";"0.0";"1.0";"0.6666666666666666";"0.3333333333333333";"1.0";"0.0";"0.0";"2"
"2862451";"Notdawa F";"617";"39";"578";"487";"130";"495";"122";"83";"null";"null";"0.06320907617504051";"0.9367909238249594";"0.7893030794165316";"0.2106969205834684";"0.8022690437601296";"0.19773095623987033";"0.13452188006482982";"115"
"2870643";"llin67";"29";"0";"29";"28";"1";"18";"11";"11";"null";"null";"0.0";"1.0";"0.9655172413793104";"0.034482758620689655";"0.6206896551724138";"0.3793103448275862";"0.3793103448275862";"1"
"2874737";"Thiago Henrique Poiani";"20";"0";"20";"19";"1";"20";"0";"0";"null";"null";"0.0";"1.0";"0.95";"0.05";"1.0";"0.0";"0.0";"1"
"638293";"maxgps";"13";"7";"6";"12";"1";"4";"9";"1";"null";"null";"0.5384615384615384";"0.46153846153846156";"0.9230769230769231";"0.07692307692307693";"0.3076923076923077";"0.6923076923076923";"0.07692307692307693";"5"
"2075969";"kamonohashi";"144";"143";"1";"0";"144";"110";"34";"0";"null";"null";"0.9930555555555556";"0.006944444444444444";"0.0";"1.0";"0.7638888888888888";"0.2361111111111111";"0.0";"2"
"2866548";"juliakloiber";"37";"0";"37";"36";"1";"37";"0";"0";"null";"null";"0.0";"1.0";"0.972972972972973";"0.02702702702702703";"1.0";"0.0";"0.0";"4"
"527721";"ninjamask";"12";"0";"12";"11";"1";"0";"12";"6";"null";"null";"0.0";"1.0";"0.9166666666666666";"0.08333333333333333";"0.0";"1.0";"0.5";"2"
"2870601";"ianiamianiam";"81";"0";"81";"80";"1";"81";"0";"0";"null";"null";"0.0";"1.0";"0.9876543209876543";"0.012345679012345678";"1.0";"0.0";"0.0";"17"
"4504865";"selimoon";"294";"0";"294";"293";"1";"201";"93";"6";"null";"null";"0.0";"1.0";"0.9965986394557823";"0.003401360544217687";"0.6836734693877551";"0.3163265306122449";"0.02040816326530612";"4"
"4246823";"SanjeevPokharel";"3";"0";"3";"2";"1";"3";"0";"0";"null";"null";"0.0";"1.0";"0.6666666666666666";"0.3333333333333333";"1.0";"0.0";"0.0";"2"
"2772288";"deadefy";"4";"1";"3";"0";"4";"1";"3";"0";"null";"null";"0.25";"0.75";"0.0";"1.0";"0.25";"0.75";"0.0";"4"
"2219338";"RichRico";"5094";"32";"5062";"5093";"1";"224";"4870";"87";"null";"null";"0.006281900274833137";"0.9937180997251669";"0.9998036906164115";"1.9630938358853554E-4";"0.04397330192383196";"0.956026698076168";"0.01707891637220259";"8"
"2932032";"Chudamani Joshi";"139";"138";"1";"0";"139";"33";"106";"32";"null";"null";"0.9928057553956835";"0.007194244604316547";"0.0";"1.0";"0.23741007194244604";"0.762589928057554";"0.2302158273381295";"17"
"1850730";"Morgan Herlocker";"111";"0";"111";"0";"111";"107";"4";"2";"null";"null";"0.0";"1.0";"0.0";"1.0";"0.963963963963964";"0.036036036036036036";"0.018018018018018018";"1"
"2874716";"André Landeck Moreira Franco Caiado";"2";"1";"1";"1";"1";"2";"0";"0";"null";"null";"0.5";"0.5";"0.5";"0.5";"1.0";"0.0";"0.0";"1"
"68982";"kisaa";"7";"2";"5";"1";"6";"0";"7";"0";"null";"null";"0.2857142857142857";"0.7142857142857143";"0.14285714285714285";"0.8571428571428571";"0.0";"1.0";"0.0";"5"
"2878807";"OBATOMI";"5";"4";"1";"4";"1";"5";"0";"0";"null";"null";"0.8";"0.2";"0.8";"0.2";"1.0";"0.0";"0.0";"1"
"179581";"Geofreund1";"54";"53";"1";"53";"1";"38";"16";"0";"null";"null";"0.9814814814814815";"0.018518518518518517";"0.9814814814814815";"0.018518518518518517";"0.7037037037037037";"0.2962962962962963";"0.0";"2"
"1789336";"Anil Gyawali";"34";"33";"1";"33";"1";"33";"1";"0";"null";"null";"0.9705882352941176";"0.029411764705882353";"0.9705882352941176";"0.029411764705882353";"0.9705882352941176";"0.029411764705882353";"0.0";"6"
"4083128";"Diwasworld";"1";"0";"1";"0";"1";"1";"0";"0";"null";"null";"0.0";"1.0";"0.0";"1.0";"1.0";"0.0";"0.0";"1"
"4722126";"Boston Ike";"1";"0";"1";"0";"1";"1";"0";"0";"null";"null";"0.0";"1.0";"0.0";"1.0";"1.0";"0.0";"0.0";"1"
"2887082";"jessamynsmith";"7";"0";"7";"0";"7";"7";"0";"0";"null";"null";"0.0";"1.0";"0.0";"1.0";"1.0";"0.0";"0.0";"1"
"4099512";"Claudio Acosta";"1";"0";"1";"0";"1";"1";"0";"0";"null";"null";"0.0";"1.0";"0.0";"1.0";"1.0";"0.0";"0.0";"1"
"4234695";"Willson Maharjan";"11";"1";"10";"5";"6";"10";"1";"0";"null";"null";"0.09090909090909091";"0.9090909090909091";"0.45454545454545453";"0.5454545454545454";"0.9090909090909091";"0.09090909090909091";"0.0";"4"
"2882979";"TauriCrab";"103";"102";"1";"102";"1";"54";"49";"23";"null";"null";"0.9902912621359223";"0.009708737864077669";"0.9902912621359223";"0.009708737864077669";"0.5242718446601942";"0.47572815533980584";"0.22330097087378642";"1"
"1854868";"Bhushan Raj Shrestha";"2";"0";"2";"1";"1";"0";"2";"0";"null";"null";"0.0";"1.0";"0.5";"0.5";"0.0";"1.0";"0.0";"2"
"4296136";"Yadav Timalsina";"10";"0";"10";"9";"1";"10";"0";"0";"null";"null";"0.0";"1.0";"0.9";"0.1";"1.0";"0.0";"0.0";"1"
"3202493";"DeepBlueSea";"22";"21";"1";"21";"1";"11";"11";"4";"null";"null";"0.9545454545454546";"0.045454545454545456";"0.9545454545454546";"0.045454545454545456";"0.5";"0.5";"0.18181818181818182";"4"
"2874789";"FunkYou";"304";"303";"1";"303";"1";"284";"20";"0";"null";"null";"0.9967105263157895";"0.003289473684210526";"0.9967105263157895";"0.003289473684210526";"0.9342105263157895";"0.06578947368421052";"0.0";"3"
"3780008";"joycecece";"6";"4";"2";"5";"1";"3";"3";"0";"null";"null";"0.6666666666666666";"0.3333333333333333";"0.8333333333333334";"0.16666666666666666";"0.5";"0.5";"0.0";"4"
"236945";"shashish";"2046";"1848";"198";"1465";"581";"1118";"928";"656";"null";"null";"0.9032258064516129";"0.0967741935483871";"0.7160312805474096";"0.28396871945259045";"0.5464320625610948";"0.45356793743890517";"0.3206256109481916";"110"
"2883001";"vbk2";"10";"0";"10";"9";"1";"10";"0";"0";"null";"null";"0.0";"1.0";"0.9";"0.1";"1.0";"0.0";"0.0";"1"
"2870718";"AneiraS";"55";"0";"55";"54";"1";"55";"0";"0";"null";"null";"0.0";"1.0";"0.9818181818181818";"0.01818181818181818";"1.0";"0.0";"0.0";"8"
"2899381";"pramool";"45";"44";"1";"44";"1";"43";"2";"1";"null";"null";"0.9777777777777777";"0.022222222222222223";"0.9777777777777777";"0.022222222222222223";"0.9555555555555556";"0.044444444444444446";"0.022222222222222223";"7"
"2887094";"MissBailey";"97";"96";"1";"41";"56";"97";"0";"0";"null";"null";"0.9896907216494846";"0.010309278350515464";"0.422680412371134";"0.5773195876288659";"1.0";"0.0";"0.0";"4"
"4521435";"Adar Amir";"1";"0";"1";"0";"1";"1";"0";"0";"null";"null";"0.0";"1.0";"0.0";"1.0";"1.0";"0.0";"0.0";"1"
"4910571";"Vinod Parihash";"3";"0";"3";"2";"1";"3";"0";"0";"null";"null";"0.0";"1.0";"0.6666666666666666";"0.3333333333333333";"1.0";"0.0";"0.0";"2"
"4836844";"Bibek Dahal";"3";"1";"2";"2";"1";"1";"2";"0";"null";"null";"0.3333333333333333";"0.6666666666666666";"0.6666666666666666";"0.3333333333333333";"0.3333333333333333";"0.6666666666666666";"0.0";"3"
"2899339";"SKRegmi";"3";"2";"1";"2";"1";"3";"0";"0";"null";"null";"0.6666666666666666";"0.3333333333333333";"0.6666666666666666";"0.3333333333333333";"1.0";"0.0";"0.0";"1"
"2874756";"Maria Clara Monteiro";"26";"25";"1";"25";"1";"26";"0";"0";"null";"null";"0.9615384615384616";"0.038461538461538464";"0.9615384615384616";"0.038461538461538464";"1.0";"0.0";"0.0";"1"
"2551191";"Jeena Mhrz";"25";"24";"1";"0";"25";"22";"3";"3";"null";"null";"0.96";"0.04";"0.0";"1.0";"0.88";"0.12";"0.12";"7"
"576954";"paully2k1";"269";"0";"269";"268";"1";"269";"0";"0";"null";"null";"0.0";"1.0";"0.9962825278810409";"0.0037174721189591076";"1.0";"0.0";"0.0";"5"
"4939256";"Padam Bist";"1";"0";"1";"0";"1";"1";"0";"0";"null";"null";"0.0";"1.0";"0.0";"1.0";"1.0";"0.0";"0.0";"1"
"454064";"vlasvlasvlas";"520";"0";"520";"0";"520";"520";"0";"0";"null";"null";"0.0";"1.0";"0.0";"1.0";"1.0";"0.0";"0.0";"1"
"4136324";"Amul Krishna";"1";"0";"1";"0";"1";"0";"1";"0";"null";"null";"0.0";"1.0";"0.0";"1.0";"0.0";"1.0";"0.0";"1"
"4488698";"Amanhattu";"2";"0";"2";"0";"2";"2";"0";"0";"null";"null";"0.0";"1.0";"0.0";"1.0";"1.0";"0.0";"0.0";"2"
"1027535";"chinghui";"66";"0";"66";"0";"66";"66";"0";"0";"null";"null";"0.0";"1.0";"0.0";"1.0";"1.0";"0.0";"0.0";"2"
"2883049";"kleo123";"335";"0";"335";"334";"1";"331";"4";"4";"null";"null";"0.0";"1.0";"0.9970149253731343";"0.0029850746268656717";"0.9880597014925373";"0.011940298507462687";"0.011940298507462687";"2"
"3481073";"nishaadhikari";"8";"7";"1";"7";"1";"4";"4";"4";"null";"null";"0.875";"0.125";"0.875";"0.125";"0.5";"0.5";"0.5";"1"
"339405";"priya";"33";"0";"33";"0";"33";"33";"0";"0";"null";"null";"0.0";"1.0";"0.0";"1.0";"1.0";"0.0";"0.0";"2"
"2551274";"saugat 2498";"117";"116";"1";"0";"117";"97";"20";"7";"null";"null";"0.9914529914529915";"0.008547008547008548";"0.0";"1.0";"0.8290598290598291";"0.17094017094017094";"0.05982905982905983";"10"
"2874855";"Johannes Homeier";"55";"54";"1";"54";"1";"55";"0";"0";"null";"null";"0.9818181818181818";"0.01818181818181818";"0.9818181818181818";"0.01818181818181818";"1.0";"0.0";"0.0";"1"
"77261";"shogungt";"32";"0";"32";"31";"1";"32";"0";"0";"null";"null";"0.0";"1.0";"0.96875";"0.03125";"1.0";"0.0";"0.0";"1"
"3415546";"Bikash gyawali";"1";"0";"1";"0";"1";"1";"0";"0";"null";"null";"0.0";"1.0";"0.0";"1.0";"1.0";"0.0";"0.0";"1"
"2862586";"cchowgule";"151";"0";"151";"150";"1";"151";"0";"0";"null";"null";"0.0";"1.0";"0.9933774834437086";"0.006622516556291391";"1.0";"0.0";"0.0";"1"
"1256907";"sunjoy79";"7";"6";"1";"6";"1";"1";"6";"0";"null";"null";"0.8571428571428571";"0.14285714285714285";"0.8571428571428571";"0.14285714285714285";"0.14285714285714285";"0.8571428571428571";"0.0";"4"
"4922774";"AlenaNarcheva";"2";"1";"1";"0";"2";"1";"1";"0";"null";"null";"0.5";"0.5";"0.0";"1.0";"0.5";"0.5";"0.0";"2"
"777685";"das-g";"271";"169";"102";"270";"1";"262";"9";"4";"null";"null";"0.6236162361623616";"0.3763837638376384";"0.996309963099631";"0.0036900369003690036";"0.966789667896679";"0.033210332103321034";"0.014760147601476014";"5"
"2797002";"Bhanu Bhakta Bhatta";"2583";"1577";"1006";"2409";"174";"1392";"1191";"407";"null";"null";"0.610530391018196";"0.3894696089818041";"0.9326364692218351";"0.06736353077816493";"0.5389082462253194";"0.4610917537746806";"0.1575687185443283";"79"
"4869547";"Utsav Bhetwal";"1";"0";"1";"0";"1";"1";"0";"0";"null";"null";"0.0";"1.0";"0.0";"1.0";"1.0";"0.0";"0.0";"1"
"1043948";"SvendJonas";"123";"0";"123";"122";"1";"123";"0";"0";"null";"null";"0.0";"1.0";"0.991869918699187";"0.008130081300813009";"1.0";"0.0";"0.0";"4"
"2899400";"osmnarayan";"1";"0";"1";"0";"1";"1";"0";"0";"null";"null";"0.0";"1.0";"0.0";"1.0";"1.0";"0.0";"0.0";"1"
"2477516";"Arunasank";"344";"0";"344";"343";"1";"322";"22";"10";"null";"null";"0.0";"1.0";"0.997093023255814";"0.0029069767441860465";"0.936046511627907";"0.06395348837209303";"0.029069767441860465";"15"
"2874822";"Hele_1";"279";"278";"1";"278";"1";"279";"0";"0";"null";"null";"0.996415770609319";"0.0035842293906810036";"0.996415770609319";"0.0035842293906810036";"1.0";"0.0";"0.0";"4"
"1863155";"bhushanshilpakar";"29";"28";"1";"28";"1";"25";"4";"4";"null";"null";"0.9655172413793104";"0.034482758620689655";"0.9655172413793104";"0.034482758620689655";"0.8620689655172413";"0.13793103448275862";"0.13793103448275862";"2"
"1117673";"Panta Shrijana";"8";"7";"1";"7";"1";"8";"0";"0";"null";"null";"0.875";"0.125";"0.875";"0.125";"1.0";"0.0";"0.0";"1"
"4910518";"Prashanna Saccos";"2";"0";"2";"1";"1";"2";"0";"0";"null";"null";"0.0";"1.0";"0.5";"0.5";"1.0";"0.0";"0.0";"2"
"4898229";"Sylvie lagrange";"2";"1";"1";"1";"1";"1";"1";"0";"null";"null";"0.5";"0.5";"0.5";"0.5";"0.5";"0.5";"0.0";"2"
"2874920";"eamartinez88";"317";"0";"317";"316";"1";"317";"0";"0";"null";"null";"0.0";"1.0";"0.9968454258675079";"0.0031545741324921135";"1.0";"0.0";"0.0";"4"
"4181558";"alexandrearanha";"2";"1";"1";"1";"1";"2";"0";"0";"null";"null";"0.5";"0.5";"0.5";"0.5";"1.0";"0.0";"0.0";"2"
"2870822";"ltv";"1039";"0";"1039";"1038";"1";"1034";"5";"0";"null";"null";"0.0";"1.0";"0.9990375360923965";"9.624639076034649E-4";"0.9951876804619827";"0.004812319538017324";"0.0";"3"
"2276915";"ashishmittal1991";"88";"87";"1";"0";"88";"57";"31";"0";"null";"null";"0.9886363636363636";"0.011363636363636364";"0.0";"1.0";"0.6477272727272727";"0.3522727272727273";"0.0";"4"
"3231272";"seattlegp";"12";"0";"12";"11";"1";"12";"0";"0";"null";"null";"0.0";"1.0";"0.9166666666666666";"0.08333333333333333";"1.0";"0.0";"0.0";"2"
"2862647";"drekmaby";"639";"638";"1";"638";"1";"334";"305";"79";"null";"null";"0.9984350547730829";"0.001564945226917058";"0.9984350547730829";"0.001564945226917058";"0.5226917057902973";"0.47730829420970267";"0.12363067292644757";"2"
"355867";"Nilk";"2";"1";"1";"1";"1";"2";"0";"0";"null";"null";"0.5";"0.5";"0.5";"0.5";"1.0";"0.0";"0.0";"2"
"359974";"hal_sk";"60";"59";"1";"59";"1";"52";"8";"0";"null";"null";"0.9833333333333333";"0.016666666666666666";"0.9833333333333333";"0.016666666666666666";"0.8666666666666667";"0.13333333333333333";"0.0";"1"
"2866703";"jhl423";"52";"0";"52";"51";"1";"52";"0";"0";"null";"null";"0.0";"1.0";"0.9807692307692307";"0.019230769230769232";"1.0";"0.0";"0.0";"1"
"2399747";"Loulou@Ayiyikoh";"781";"0";"781";"0";"781";"781";"0";"0";"null";"null";"0.0";"1.0";"0.0";"1.0";"1.0";"0.0";"0.0";"8"
"4955747";"Richard Maharjan";"4";"0";"4";"2";"2";"4";"0";"0";"null";"null";"0.0";"1.0";"0.5";"0.5";"1.0";"0.0";"0.0";"2"
"3255834";"Aayurveda";"1";"0";"1";"0";"1";"1";"0";"0";"null";"null";"0.0";"1.0";"0.0";"1.0";"1.0";"0.0";"0.0";"1"
"2866695";"Elly Hall";"232";"0";"232";"231";"1";"218";"14";"0";"null";"null";"0.0";"1.0";"0.9956896551724138";"0.004310344827586207";"0.9396551724137931";"0.0603448275862069";"0.0";"1"
"4976230";"Bijay Thapa";"1";"0";"1";"0";"1";"0";"1";"0";"null";"null";"0.0";"1.0";"0.0";"1.0";"0.0";"1.0";"0.0";"1"
"2874906";"Byungyun";"22";"0";"22";"21";"1";"22";"0";"0";"null";"null";"0.0";"1.0";"0.9545454545454546";"0.045454545454545456";"1.0";"0.0";"0.0";"4"
"2264597";"VectorB";"23";"0";"23";"22";"1";"12";"11";"0";"null";"null";"0.0";"1.0";"0.9565217391304348";"0.043478260869565216";"0.5217391304347826";"0.4782608695652174";"0.0";"2"
"2891291";"bzbuzzard";"28";"0";"28";"27";"1";"28";"0";"0";"null";"null";"0.0";"1.0";"0.9642857142857143";"0.03571428571428571";"1.0";"0.0";"0.0";"1"
"4361848";"Alesya Osadchaya";"1";"0";"1";"0";"1";"0";"1";"0";"null";"null";"0.0";"1.0";"0.0";"1.0";"0.0";"1.0";"0.0";"1"
"4529784";"sujan_rdm";"6";"0";"6";"5";"1";"6";"0";"0";"null";"null";"0.0";"1.0";"0.8333333333333334";"0.16666666666666666";"1.0";"0.0";"0.0";"6"
"5054067";"Sasha Malla";"5";"4";"1";"0";"5";"4";"1";"0";"null";"null";"0.8";"0.2";"0.0";"1.0";"0.8";"0.2";"0.0";"1"
"2883093";"nepab";"6";"0";"6";"5";"1";"6";"0";"0";"null";"null";"0.0";"1.0";"0.8333333333333334";"0.16666666666666666";"1.0";"0.0";"0.0";"1"
"24126";"dforsi";"1";"0";"1";"0";"1";"0";"1";"0";"null";"null";"0.0";"1.0";"0.0";"1.0";"0.0";"1.0";"0.0";"1"
"4488708";"pranabzs";"1";"0";"1";"0";"1";"1";"0";"0";"null";"null";"0.0";"1.0";"0.0";"1.0";"1.0";"0.0";"0.0";"1"
"3456631";"ppanday";"4";"0";"4";"3";"1";"4";"0";"0";"null";"null";"0.0";"1.0";"0.75";"0.25";"1.0";"0.0";"0.0";"1"
"4840973";"Jacqueline Curry";"3";"0";"3";"0";"3";"3";"0";"0";"null";"null";"0.0";"1.0";"0.0";"1.0";"1.0";"0.0";"0.0";"2"
"4873740";"sxuvam chettri";"1";"0";"1";"0";"1";"1";"0";"0";"null";"null";"0.0";"1.0";"0.0";"1.0";"1.0";"0.0";"0.0";"1"
"3911293";"bzendra";"193";"192";"1";"192";"1";"114";"79";"0";"null";"null";"0.9948186528497409";"0.0051813471502590676";"0.9948186528497409";"0.0051813471502590676";"0.5906735751295337";"0.40932642487046633";"0.0";"1"
"4488707";"lazycaveman";"1";"0";"1";"0";"1";"1";"0";"0";"null";"null";"0.0";"1.0";"0.0";"1.0";"1.0";"0.0";"0.0";"1"
"4488716";"OSMNabin";"7";"0";"7";"5";"2";"7";"0";"0";"null";"null";"0.0";"1.0";"0.7142857142857143";"0.2857142857142857";"1.0";"0.0";"0.0";"3"
"4836866";"ashish pulami";"2";"1";"1";"1";"1";"1";"1";"0";"null";"null";"0.5";"0.5";"0.5";"0.5";"0.5";"0.5";"0.0";"2"
"3878516";"openmap1";"15";"14";"1";"14";"1";"15";"0";"0";"null";"null";"0.9333333333333333";"0.06666666666666667";"0.9333333333333333";"0.06666666666666667";"1.0";"0.0";"0.0";"2"
"3911278";"ayushupreti22";"380";"300";"80";"176";"204";"272";"108";"1";"null";"null";"0.7894736842105263";"0.21052631578947367";"0.4631578947368421";"0.5368421052631579";"0.7157894736842105";"0.28421052631578947";"0.002631578947368421";"49"
"2879100";"redwisdom";"296";"234";"62";"295";"1";"246";"50";"0";"null";"null";"0.7905405405405406";"0.20945945945945946";"0.9966216216216216";"0.0033783783783783786";"0.831081081081081";"0.16891891891891891";"0.0";"2"
"2874993";"Samara1973";"4";"0";"4";"3";"1";"4";"0";"0";"null";"null";"0.0";"1.0";"0.75";"0.25";"1.0";"0.0";"0.0";"1"
"2477694";"Tenzing Sherpa";"1";"0";"1";"0";"1";"0";"1";"0";"null";"null";"0.0";"1.0";"0.0";"1.0";"0.0";"1.0";"0.0";"1"
"4931092";"Aayush kc";"1";"0";"1";"0";"1";"1";"0";"0";"null";"null";"0.0";"1.0";"0.0";"1.0";"1.0";"0.0";"0.0";"1"
"1379953";"montseferrer";"202";"201";"1";"201";"1";"202";"0";"0";"null";"null";"0.995049504950495";"0.0049504950495049506";"0.995049504950495";"0.0049504950495049506";"1.0";"0.0";"0.0";"1"
"1863285";"jyun76";"997";"996";"1";"124";"873";"947";"50";"6";"null";"null";"0.9989969909729187";"0.0010030090270812437";"0.12437311935807423";"0.8756268806419257";"0.9498495486459378";"0.05015045135406219";"0.006018054162487462";"7"
"2883138";"Manish Kokh";"1";"0";"1";"0";"1";"0";"1";"0";"null";"null";"0.0";"1.0";"0.0";"1.0";"0.0";"1.0";"0.0";"1"
"2866752";"paren8esis";"16";"0";"16";"15";"1";"16";"0";"0";"null";"null";"0.0";"1.0";"0.9375";"0.0625";"1.0";"0.0";"0.0";"2"
"2883136";"omidm";"30";"0";"30";"29";"1";"30";"0";"0";"null";"null";"0.0";"1.0";"0.9666666666666667";"0.03333333333333333";"1.0";"0.0";"0.0";"3"
"4849189";"3 way Restaurant and bar";"2";"1";"1";"1";"1";"2";"0";"0";"null";"null";"0.5";"0.5";"0.5";"0.5";"1.0";"0.0";"0.0";"1"
"2874951";"Silje Wendelborg Fremo";"290";"0";"290";"289";"1";"290";"0";"0";"null";"null";"0.0";"1.0";"0.996551724137931";"0.0034482758620689655";"1.0";"0.0";"0.0";"4"
"2907741";"mapconcierge_tech";"4";"0";"4";"3";"1";"3";"1";"0";"null";"null";"0.0";"1.0";"0.75";"0.25";"0.75";"0.25";"0.0";"2"
"5025342";"Bikash Jindal";"2";"0";"2";"1";"1";"2";"0";"0";"null";"null";"0.0";"1.0";"0.5";"0.5";"1.0";"0.0";"0.0";"1"
"5037627";"Babin Joshi";"1";"0";"1";"0";"1";"1";"0";"0";"null";"null";"0.0";"1.0";"0.0";"1.0";"1.0";"0.0";"0.0";"1"
"2248282";"susan1298";"58";"24";"34";"57";"1";"41";"17";"7";"null";"null";"0.41379310344827586";"0.5862068965517241";"0.9827586206896551";"0.017241379310344827";"0.7068965517241379";"0.29310344827586204";"0.1206896551724138";"12"
"2899541";"abhicsr";"12";"11";"1";"11";"1";"12";"0";"0";"null";"null";"0.9166666666666666";"0.08333333333333333";"0.9166666666666666";"0.08333333333333333";"1.0";"0.0";"0.0";"3"
"2866774";"kgallant";"18";"0";"18";"17";"1";"18";"0";"0";"null";"null";"0.0";"1.0";"0.9444444444444444";"0.05555555555555555";"1.0";"0.0";"0.0";"2"
"4009656";"Ram Pukar Jha";"1";"0";"1";"0";"1";"1";"0";"0";"null";"null";"0.0";"1.0";"0.0";"1.0";"1.0";"0.0";"0.0";"1"
"421504";"u_kubota";"109";"0";"109";"108";"1";"109";"0";"0";"null";"null";"0.0";"1.0";"0.9908256880733946";"0.009174311926605505";"1.0";"0.0";"0.0";"1"
"3497660";"Kathmandu Tourist Home";"5";"4";"1";"0";"5";"3";"2";"1";"null";"null";"0.8";"0.2";"0.0";"1.0";"0.6";"0.4";"0.2";"3"
"1961615";"Samorn";"6";"5";"1";"5";"1";"2";"4";"2";"null";"null";"0.8333333333333334";"0.16666666666666666";"0.8333333333333334";"0.16666666666666666";"0.3333333333333333";"0.6666666666666666";"0.3333333333333333";"1"
"5050079";"Rabin Sharma";"4";"3";"1";"3";"1";"3";"1";"0";"null";"null";"0.75";"0.25";"0.75";"0.25";"0.75";"0.25";"0.0";"2"
"4136614";"Prashant Khanal";"2";"1";"1";"0";"2";"2";"0";"0";"null";"null";"0.5";"0.5";"0.0";"1.0";"1.0";"0.0";"0.0";"1"
"4980439";"Upendra21";"5";"0";"5";"0";"5";"5";"0";"0";"null";"null";"0.0";"1.0";"0.0";"1.0";"1.0";"0.0";"0.0";"2"
"2883254";"David Pitcher";"141";"0";"141";"140";"1";"121";"20";"4";"null";"null";"0.0";"1.0";"0.9929078014184397";"0.0070921985815602835";"0.8581560283687943";"0.14184397163120568";"0.028368794326241134";"2"
"4497114";"Deepesh Choudhary";"2";"1";"1";"1";"1";"2";"0";"0";"null";"null";"0.5";"0.5";"0.5";"0.5";"1.0";"0.0";"0.0";"1"
"2903684";"ranjit shingh";"15";"14";"1";"0";"15";"14";"1";"1";"null";"null";"0.9333333333333333";"0.06666666666666667";"0.0";"1.0";"0.9333333333333333";"0.06666666666666667";"0.06666666666666667";"1"
"2883201";"dagmarlintu";"22";"0";"22";"21";"1";"10";"12";"0";"null";"null";"0.0";"1.0";"0.9545454545454546";"0.045454545454545456";"0.45454545454545453";"0.5454545454545454";"0.0";"3"
"1371833";"mgrubinger";"2";"1";"1";"1";"1";"1";"1";"0";"null";"null";"0.5";"0.5";"0.5";"0.5";"0.5";"0.5";"0.0";"2"
"2879108";"Alex_88";"611";"279";"332";"610";"1";"355";"256";"19";"null";"null";"0.45662847790507366";"0.5433715220949263";"0.9983633387888707";"0.0016366612111292963";"0.5810147299509002";"0.41898527004909986";"0.031096563011456628";"11"
"4554484";"Kaji Thebe";"7";"0";"7";"1";"6";"6";"1";"0";"null";"null";"0.0";"1.0";"0.14285714285714285";"0.8571428571428571";"0.8571428571428571";"0.14285714285714285";"0.0";"5"
"4976378";"Dipeshcarkey";"2";"0";"2";"1";"1";"2";"0";"0";"null";"null";"0.0";"1.0";"0.5";"0.5";"1.0";"0.0";"0.0";"1"
"5000957";"Manzay Rst";"4";"3";"1";"3";"1";"4";"0";"0";"null";"null";"0.75";"0.25";"0.75";"0.25";"1.0";"0.0";"0.0";"1"
"3415687";"wizardofoz";"145";"75";"70";"129";"16";"70";"75";"39";"null";"null";"0.5172413793103449";"0.4827586206896552";"0.8896551724137931";"0.1103448275862069";"0.4827586206896552";"0.5172413793103449";"0.2689655172413793";"39"
"3591808";"ampshoe";"6";"0";"6";"5";"1";"4";"2";"0";"null";"null";"0.0";"1.0";"0.8333333333333334";"0.16666666666666666";"0.6666666666666666";"0.3333333333333333";"0.0";"3"
"2866839";"Dpbours";"19";"0";"19";"18";"1";"19";"0";"0";"null";"null";"0.0";"1.0";"0.9473684210526315";"0.05263157894736842";"1.0";"0.0";"0.0";"1"
"2326240";"Sazeeta";"61";"57";"4";"12";"49";"51";"10";"6";"null";"null";"0.9344262295081968";"0.06557377049180328";"0.19672131147540983";"0.8032786885245902";"0.8360655737704918";"0.16393442622950818";"0.09836065573770492";"13"
"2875117";"Wingpeople";"120";"86";"34";"119";"1";"104";"16";"0";"null";"null";"0.7166666666666667";"0.2833333333333333";"0.9916666666666667";"0.008333333333333333";"0.8666666666666667";"0.13333333333333333";"0.0";"5"
"4300422";"Another Voice";"2";"0";"2";"1";"1";"2";"0";"0";"null";"null";"0.0";"1.0";"0.5";"0.5";"1.0";"0.0";"0.0";"2"
"2875108";"ponni_92";"522";"0";"522";"521";"1";"522";"0";"0";"null";"null";"0.0";"1.0";"0.9980842911877394";"0.0019157088122605363";"1.0";"0.0";"0.0";"2"
"2326258";"Santosh Baral";"26";"0";"26";"25";"1";"25";"1";"1";"null";"null";"0.0";"1.0";"0.9615384615384616";"0.038461538461538464";"0.9615384615384616";"0.038461538461538464";"0.038461538461538464";"3"
"2858751";"DSHJR";"4";"0";"4";"0";"4";"3";"1";"1";"null";"null";"0.0";"1.0";"0.0";"1.0";"0.75";"0.25";"0.25";"2"
"2875122";"Steve Pack";"184";"0";"184";"183";"1";"184";"0";"0";"null";"null";"0.0";"1.0";"0.9945652173913043";"0.005434782608695652";"1.0";"0.0";"0.0";"1"
"2871025";"Hilla H";"254";"0";"254";"253";"1";"254";"0";"0";"null";"null";"0.0";"1.0";"0.9960629921259843";"0.003937007874015748";"1.0";"0.0";"0.0";"4"
"2674419";"M15462345";"144";"0";"144";"143";"1";"135";"9";"0";"null";"null";"0.0";"1.0";"0.9930555555555556";"0.006944444444444444";"0.9375";"0.0625";"0.0";"1"
"5037712";"Govinda Adhikari";"1";"0";"1";"0";"1";"1";"0";"0";"null";"null";"0.0";"1.0";"0.0";"1.0";"1.0";"0.0";"0.0";"1"
"3911386";"Prashan Pokharel";"1";"0";"1";"0";"1";"1";"0";"0";"null";"null";"0.0";"1.0";"0.0";"1.0";"1.0";"0.0";"0.0";"1"
"1613562";"bslpkr";"4";"0";"4";"0";"4";"0";"4";"4";"null";"null";"0.0";"1.0";"0.0";"1.0";"0.0";"1.0";"1.0";"1"
"4972205";"nawint";"1";"0";"1";"0";"1";"1";"0";"0";"null";"null";"0.0";"1.0";"0.0";"1.0";"1.0";"0.0";"0.0";"1"
"810731";"Paroparo13";"1";"0";"1";"0";"1";"1";"0";"0";"null";"null";"0.0";"1.0";"0.0";"1.0";"1.0";"0.0";"0.0";"1"
"4558498";"AMCL";"1";"0";"1";"0";"1";"1";"0";"0";"null";"null";"0.0";"1.0";"0.0";"1.0";"1.0";"0.0";"0.0";"1"
"4275880";"Ajendra Dangol";"15";"0";"15";"0";"15";"15";"0";"0";"null";"null";"0.0";"1.0";"0.0";"1.0";"1.0";"0.0";"0.0";"2"
"2629315";"Suraj Sakya";"17";"16";"1";"16";"1";"6";"11";"10";"null";"null";"0.9411764705882353";"0.058823529411764705";"0.9411764705882353";"0.058823529411764705";"0.35294117647058826";"0.6470588235294118";"0.5882352941176471";"4"
"2498250";"scrpnhrt";"55";"0";"55";"54";"1";"26";"29";"11";"null";"null";"0.0";"1.0";"0.9818181818181818";"0.01818181818181818";"0.4727272727272727";"0.5272727272727272";"0.2";"6"
"3333853";"nammyhang";"25";"0";"25";"0";"25";"21";"4";"4";"null";"null";"0.0";"1.0";"0.0";"1.0";"0.84";"0.16";"0.16";"3"
"4464309";"NiRan RiDer";"2";"1";"1";"1";"1";"2";"0";"0";"null";"null";"0.5";"0.5";"0.5";"0.5";"1.0";"0.0";"0.0";"2"
"4964025";"Niroj Amatya";"1";"0";"1";"0";"1";"1";"0";"0";"null";"null";"0.0";"1.0";"0.0";"1.0";"1.0";"0.0";"0.0";"1"
"4390577";"Rajan Dangol";"1";"0";"1";"0";"1";"1";"0";"0";"null";"null";"0.0";"1.0";"0.0";"1.0";"1.0";"0.0";"0.0";"1"
"2326231";"Shaishab Kishor Shrestha";"67";"20";"47";"45";"22";"46";"21";"5";"null";"null";"0.29850746268656714";"0.7014925373134329";"0.6716417910447762";"0.3283582089552239";"0.6865671641791045";"0.31343283582089554";"0.07462686567164178";"11"
"4980414";"Sujanthapa403";"5";"0";"5";"0";"5";"5";"0";"0";"null";"null";"0.0";"1.0";"0.0";"1.0";"1.0";"0.0";"0.0";"2"
"204539";"ramlaxman";"16";"2";"14";"0";"16";"12";"4";"0";"null";"null";"0.125";"0.875";"0.0";"1.0";"0.75";"0.25";"0.0";"4"
"2326233";"rupa12";"63";"62";"1";"0";"63";"60";"3";"1";"null";"null";"0.9841269841269841";"0.015873015873015872";"0.0";"1.0";"0.9523809523809523";"0.047619047619047616";"0.015873015873015872";"9"
"2326232";"Sophina";"52";"6";"46";"51";"1";"35";"17";"7";"null";"null";"0.11538461538461539";"0.8846153846153846";"0.9807692307692307";"0.019230769230769232";"0.6730769230769231";"0.3269230769230769";"0.1346153846153846";"5"
"4841141";"Arman Lurye";"13";"4";"9";"9";"4";"10";"3";"0";"null";"null";"0.3076923076923077";"0.6923076923076923";"0.6923076923076923";"0.3076923076923077";"0.7692307692307693";"0.23076923076923078";"0.0";"13"
"3428041";"greenshiva";"26";"25";"1";"25";"1";"26";"0";"0";"null";"null";"0.9615384615384616";"0.038461538461538464";"0.9615384615384616";"0.038461538461538464";"1.0";"0.0";"0.0";"1"
"2326237";"Tammy7723";"5";"4";"1";"0";"5";"5";"0";"0";"null";"null";"0.8";"0.2";"0.0";"1.0";"1.0";"0.0";"0.0";"2"
"4791991";"Hotel Wanderlust";"1";"0";"1";"0";"1";"1";"0";"0";"null";"null";"0.0";"1.0";"0.0";"1.0";"1.0";"0.0";"0.0";"1"
"2883370";"darpant";"135";"0";"135";"28";"107";"135";"0";"0";"null";"null";"0.0";"1.0";"0.2074074074074074";"0.7925925925925926";"1.0";"0.0";"0.0";"24"
"2858794";"張明智（挨滴貨）";"38";"0";"38";"37";"1";"38";"0";"0";"null";"null";"0.0";"1.0";"0.9736842105263158";"0.02631578947368421";"1.0";"0.0";"0.0";"2"
"3268403";"arjun gautam";"67";"66";"1";"66";"1";"12";"55";"22";"null";"null";"0.9850746268656716";"0.014925373134328358";"0.9850746268656716";"0.014925373134328358";"0.1791044776119403";"0.8208955223880597";"0.3283582089552239";"4"
"1240849";"ediyes";"15665";"2528";"13137";"15664";"1";"9988";"5677";"2029";"null";"null";"0.16137887009256305";"0.838621129907437";"0.9999361634216406";"6.383657835939994E-5";"0.6375997446536865";"0.3624002553463134";"0.12952441749122248";"208"
"2875183";"Torgeir Sandøy";"36";"0";"36";"35";"1";"19";"17";"0";"null";"null";"0.0";"1.0";"0.9722222222222222";"0.027777777777777776";"0.5277777777777778";"0.4722222222222222";"0.0";"1"
"1855257";"Huang AMing";"382";"317";"65";"0";"382";"368";"14";"0";"null";"null";"0.8298429319371727";"0.17015706806282724";"0.0";"1.0";"0.9633507853403142";"0.03664921465968586";"0.0";"5"
"2875171";"rajuneupane";"23";"0";"23";"22";"1";"22";"1";"0";"null";"null";"0.0";"1.0";"0.9565217391304348";"0.043478260869565216";"0.9565217391304348";"0.043478260869565216";"0.0";"1"
"2748195";"karitotp";"32395";"13235";"19160";"32394";"1";"6693";"25702";"3560";"null";"null";"0.40855070226886864";"0.5914492977311313";"0.9999691310387405";"3.086896125945362E-5";"0.20660595770952309";"0.7933940422904769";"0.10989350208365488";"61"
"2875168";"JShak";"2";"0";"2";"1";"1";"0";"2";"1";"null";"null";"0.0";"1.0";"0.5";"0.5";"0.0";"1.0";"0.5";"1"
"2887485";"Dipendra Pokharel";"12";"0";"12";"0";"12";"8";"4";"0";"null";"null";"0.0";"1.0";"0.0";"1.0";"0.6666666666666666";"0.3333333333333333";"0.0";"3"
"589596";"lxbarth";"4";"0";"4";"3";"1";"4";"0";"0";"null";"null";"0.0";"1.0";"0.75";"0.25";"1.0";"0.0";"0.0";"1"
"2867005";"swsun214";"720";"0";"720";"719";"1";"720";"0";"0";"null";"null";"0.0";"1.0";"0.9986111111111111";"0.001388888888888889";"1.0";"0.0";"0.0";"10"
"2092806";"cogintheMACHINE";"4";"3";"1";"3";"1";"4";"0";"0";"null";"null";"0.75";"0.25";"0.75";"0.25";"1.0";"0.0";"0.0";"1"
"2875190";"AnnaSeither";"17";"16";"1";"16";"1";"11";"6";"6";"null";"null";"0.9411764705882353";"0.058823529411764705";"0.9411764705882353";"0.058823529411764705";"0.6470588235294118";"0.35294117647058826";"0.35294117647058826";"1"
"2875147";"mhh1111";"344";"0";"344";"343";"1";"324";"20";"17";"null";"null";"0.0";"1.0";"0.997093023255814";"0.0029069767441860465";"0.9418604651162791";"0.05813953488372093";"0.04941860465116279";"3"
"2875145";"EvenEivind";"4";"0";"4";"3";"1";"4";"0";"0";"null";"null";"0.0";"1.0";"0.75";"0.25";"1.0";"0.0";"0.0";"1"
"2875151";"idaopsahl";"303";"0";"303";"302";"1";"302";"1";"0";"null";"null";"0.0";"1.0";"0.9966996699669967";"0.0033003300330033004";"0.9966996699669967";"0.0033003300330033004";"0.0";"3"
"679726";"Sgilbert";"10";"0";"10";"9";"1";"10";"0";"0";"null";"null";"0.0";"1.0";"0.9";"0.1";"1.0";"0.0";"0.0";"1"
"2879245";"wildflowers";"99";"98";"1";"98";"1";"95";"4";"4";"null";"null";"0.98989898989899";"0.010101010101010102";"0.98989898989899";"0.010101010101010102";"0.9595959595959596";"0.04040404040404041";"0.04040404040404041";"1"
"2875139";"amuola";"31";"0";"31";"30";"1";"31";"0";"0";"null";"null";"0.0";"1.0";"0.967741935483871";"0.03225806451612903";"1.0";"0.0";"0.0";"1"
"4890467";"PREM YADAV";"1";"0";"1";"0";"1";"1";"0";"0";"null";"null";"0.0";"1.0";"0.0";"1.0";"1.0";"0.0";"0.0";"1"
"4689773";"Aman Gurung";"2";"0";"2";"1";"1";"2";"0";"0";"null";"null";"0.0";"1.0";"0.5";"0.5";"1.0";"0.0";"0.0";"2"
"347944";"matthewsheffield";"99";"98";"1";"98";"1";"69";"30";"4";"null";"null";"0.98989898989899";"0.010101010101010102";"0.98989898989899";"0.010101010101010102";"0.696969696969697";"0.30303030303030304";"0.04040404040404041";"3"
"2887425";"Sushan Shrestha";"2";"0";"2";"0";"2";"1";"1";"0";"null";"null";"0.0";"1.0";"0.0";"1.0";"0.5";"0.5";"0.0";"2"
"4427634";"Sahayogi";"7";"4";"3";"5";"2";"6";"1";"0";"null";"null";"0.5714285714285714";"0.42857142857142855";"0.7142857142857143";"0.2857142857142857";"0.8571428571428571";"0.14285714285714285";"0.0";"7"
"3628804";"Nemi123";"11";"10";"1";"10";"1";"11";"0";"0";"null";"null";"0.9090909090909091";"0.09090909090909091";"0.9090909090909091";"0.09090909090909091";"1.0";"0.0";"0.0";"1"
"2866968";"Diwas";"125";"124";"1";"124";"1";"111";"14";"0";"null";"null";"0.992";"0.008";"0.992";"0.008";"0.888";"0.112";"0.0";"2"
"2559774";"Sulav Malla";"1";"0";"1";"0";"1";"1";"0";"0";"null";"null";"0.0";"1.0";"0.0";"1.0";"1.0";"0.0";"0.0";"1"
"4456313";"Rakesh ranjitkar";"2";"0";"2";"1";"1";"2";"0";"0";"null";"null";"0.0";"1.0";"0.5";"0.5";"1.0";"0.0";"0.0";"2"
"1814304";"Vrag";"66";"0";"66";"65";"1";"54";"12";"1";"null";"null";"0.0";"1.0";"0.9848484848484849";"0.015151515151515152";"0.8181818181818182";"0.18181818181818182";"0.015151515151515152";"3"
"1707814";"de vries";"81";"0";"81";"80";"1";"81";"0";"0";"null";"null";"0.0";"1.0";"0.9876543209876543";"0.012345679012345678";"1.0";"0.0";"0.0";"2"
"2551577";"Anil Kumar Sah";"62";"43";"19";"61";"1";"11";"51";"33";"null";"null";"0.6935483870967742";"0.3064516129032258";"0.9838709677419355";"0.016129032258064516";"0.1774193548387097";"0.8225806451612904";"0.532258064516129";"4"
"2883435";"AJ Farkas";"1189";"0";"1189";"1188";"1";"1181";"8";"0";"null";"null";"0.0";"1.0";"0.9991589571068125";"8.410428931875525E-4";"0.9932716568544996";"0.00672834314550042";"0.0";"5"
"2879338";"amrutha92";"16";"7";"9";"15";"1";"16";"0";"0";"null";"null";"0.4375";"0.5625";"0.9375";"0.0625";"1.0";"0.0";"0.0";"3"
"2875246";"fluedtke";"49";"0";"49";"48";"1";"49";"0";"0";"null";"null";"0.0";"1.0";"0.9795918367346939";"0.02040816326530612";"1.0";"0.0";"0.0";"1"
"2883437";"Nhamlish";"30";"0";"30";"29";"1";"26";"4";"4";"null";"null";"0.0";"1.0";"0.9666666666666667";"0.03333333333333333";"0.8666666666666667";"0.13333333333333333";"0.13333333333333333";"2"
"77642";"CptJumbo";"309";"308";"1";"308";"1";"309";"0";"0";"null";"null";"0.9967637540453075";"0.003236245954692557";"0.9967637540453075";"0.003236245954692557";"1.0";"0.0";"0.0";"3"
"2867065";"RS2015";"14";"0";"14";"13";"1";"14";"0";"0";"null";"null";"0.0";"1.0";"0.9285714285714286";"0.07142857142857142";"1.0";"0.0";"0.0";"2"
"4943640";"Gop$";"1";"0";"1";"0";"1";"1";"0";"0";"null";"null";"0.0";"1.0";"0.0";"1.0";"1.0";"0.0";"0.0";"1"
"2867070";"yodooli";"1022";"235";"787";"1021";"1";"779";"243";"205";"null";"null";"0.2299412915851272";"0.7700587084148728";"0.9990215264187867";"9.784735812133072E-4";"0.7622309197651663";"0.23776908023483365";"0.20058708414872797";"7"
"4288279";"Pasang Khambache Sherpa";"2";"0";"2";"1";"1";"2";"0";"0";"null";"null";"0.0";"1.0";"0.5";"0.5";"1.0";"0.0";"0.0";"1"
"2629502";"Solarize Nepal";"4";"0";"4";"3";"1";"0";"4";"0";"null";"null";"0.0";"1.0";"0.75";"0.25";"0.0";"1.0";"0.0";"1"
"2613116";"henjil";"64";"28";"36";"28";"36";"25";"39";"16";"null";"null";"0.4375";"0.5625";"0.4375";"0.5625";"0.390625";"0.609375";"0.25";"3"
"3276653";"Suman Timilsina";"19";"0";"19";"18";"1";"10";"9";"0";"null";"null";"0.0";"1.0";"0.9473684210526315";"0.05263157894736842";"0.5263157894736842";"0.47368421052631576";"0.0";"2"
"2875254";"Quinniem";"117";"0";"117";"116";"1";"78";"39";"22";"null";"null";"0.0";"1.0";"0.9914529914529915";"0.008547008547008548";"0.6666666666666666";"0.3333333333333333";"0.18803418803418803";"1"
"2871158";"oculogyrus";"2";"0";"2";"1";"1";"0";"2";"2";"null";"null";"0.0";"1.0";"0.5";"0.5";"0.0";"1.0";"1.0";"1"
"3276654";"roshan khatun";"13";"0";"13";"12";"1";"4";"9";"0";"null";"null";"0.0";"1.0";"0.9230769230769231";"0.07692307692307693";"0.3076923076923077";"0.6923076923076923";"0.0";"1"
"2875209";"Waldschrat82";"10";"0";"10";"0";"10";"4";"6";"0";"null";"null";"0.0";"1.0";"0.0";"1.0";"0.4";"0.6";"0.0";"1"
"3276626";"Rajan Jamakatel";"10";"0";"10";"9";"1";"10";"0";"0";"null";"null";"0.0";"1.0";"0.9";"0.1";"1.0";"0.0";"0.0";"1"
"4800301";"Karma Ghale";"22";"16";"6";"20";"2";"20";"2";"0";"null";"null";"0.7272727272727273";"0.2727272727272727";"0.9090909090909091";"0.09090909090909091";"0.9090909090909091";"0.09090909090909091";"0.0";"6"
"3276629";"creezan";"2";"0";"2";"1";"1";"2";"0";"0";"null";"null";"0.0";"1.0";"0.5";"0.5";"1.0";"0.0";"0.0";"1"
"1240951";"asujan";"13";"12";"1";"12";"1";"0";"13";"0";"null";"null";"0.9230769230769231";"0.07692307692307693";"0.9230769230769231";"0.07692307692307693";"0.0";"1.0";"0.0";"1"
"2883405";"blueberrypatch";"154";"0";"154";"0";"154";"146";"8";"8";"null";"null";"0.0";"1.0";"0.0";"1.0";"0.948051948051948";"0.05194805194805195";"0.05194805194805195";"1"
"5041962";"Bishwo Ram Bhandari";"1";"0";"1";"0";"1";"1";"0";"0";"null";"null";"0.0";"1.0";"0.0";"1.0";"1.0";"0.0";"0.0";"1"
"3985243";"Chris Everywhere";"1";"0";"1";"0";"1";"1";"0";"0";"null";"null";"0.0";"1.0";"0.0";"1.0";"1.0";"0.0";"0.0";"1"
"2879308";"Ashanna SNB";"90";"0";"90";"89";"1";"90";"0";"0";"null";"null";"0.0";"1.0";"0.9888888888888889";"0.011111111111111112";"1.0";"0.0";"0.0";"4"
"3276633";"sameeracharya";"3";"0";"3";"2";"1";"2";"1";"0";"null";"null";"0.0";"1.0";"0.6666666666666666";"0.3333333333333333";"0.6666666666666666";"0.3333333333333333";"0.0";"1"
"2875201";"janjak";"6";"0";"6";"5";"1";"0";"6";"6";"null";"null";"0.0";"1.0";"0.8333333333333334";"0.16666666666666666";"0.0";"1.0";"1.0";"1"
"4849445";"Rajan shahi";"2";"1";"1";"1";"1";"2";"0";"0";"null";"null";"0.5";"0.5";"0.5";"0.5";"1.0";"0.0";"0.0";"1"
"3276611";"santosh pokhrel";"7";"0";"7";"6";"1";"6";"1";"0";"null";"null";"0.0";"1.0";"0.8571428571428571";"0.14285714285714285";"0.8571428571428571";"0.14285714285714285";"0.0";"1"
"2862936";"Preyankah";"48";"0";"48";"47";"1";"48";"0";"0";"null";"null";"0.0";"1.0";"0.9791666666666666";"0.020833333333333332";"1.0";"0.0";"0.0";"1"
"24440";"jaakkoh";"1";"0";"1";"0";"1";"1";"0";"0";"null";"null";"0.0";"1.0";"0.0";"1.0";"1.0";"0.0";"0.0";"1"
"3276616";"Suvani";"8";"0";"8";"7";"1";"8";"0";"0";"null";"null";"0.0";"1.0";"0.875";"0.125";"1.0";"0.0";"0.0";"1"
"4464447";"stondus";"8";"7";"1";"7";"1";"3";"5";"0";"null";"null";"0.875";"0.125";"0.875";"0.125";"0.375";"0.625";"0.0";"2"
"290680";"wheelmap_visitor";"1";"0";"1";"0";"1";"0";"1";"0";"null";"null";"0.0";"1.0";"0.0";"1.0";"0.0";"1.0";"0.0";"1"
"3276620";"sujita bhandari";"4";"0";"4";"3";"1";"4";"0";"0";"null";"null";"0.0";"1.0";"0.75";"0.25";"1.0";"0.0";"0.0";"1"
"16256";"patzi";"303";"302";"1";"302";"1";"250";"53";"0";"null";"null";"0.9966996699669967";"0.0033003300330033004";"0.9966996699669967";"0.0033003300330033004";"0.8250825082508251";"0.17491749174917492";"0.0";"4"
"2875307";"KnutBj";"367";"0";"367";"366";"1";"353";"14";"0";"null";"null";"0.0";"1.0";"0.997275204359673";"0.0027247956403269754";"0.9618528610354223";"0.03814713896457766";"0.0";"8"
"2383780";"Alane Konan";"4";"0";"4";"0";"4";"4";"0";"0";"null";"null";"0.0";"1.0";"0.0";"1.0";"1.0";"0.0";"0.0";"1"
"4968394";"Dipak Rai";"3";"2";"1";"2";"1";"1";"2";"0";"null";"null";"0.6666666666666666";"0.3333333333333333";"0.6666666666666666";"0.3333333333333333";"0.3333333333333333";"0.6666666666666666";"0.0";"2"
"315271";"peyot";"150";"149";"1";"149";"1";"103";"47";"0";"null";"null";"0.9933333333333333";"0.006666666666666667";"0.9933333333333333";"0.006666666666666667";"0.6866666666666666";"0.31333333333333335";"0.0";"1"
"3977151";"Marco Cassol";"1";"0";"1";"0";"1";"1";"0";"0";"null";"null";"0.0";"1.0";"0.0";"1.0";"1.0";"0.0";"0.0";"1"
"5005251";"Prashant Pradhan";"2";"1";"1";"1";"1";"2";"0";"0";"null";"null";"0.5";"0.5";"0.5";"0.5";"1.0";"0.0";"0.0";"1"
"4521931";"JKunwar";"4";"3";"1";"3";"1";"3";"1";"0";"null";"null";"0.75";"0.25";"0.75";"0.25";"0.75";"0.25";"0.0";"1"
"4022188";"Chhabi Lal Khanal";"5";"4";"1";"4";"1";"2";"3";"1";"null";"null";"0.8";"0.2";"0.8";"0.2";"0.4";"0.6";"0.2";"3"
"1539973";"Atuladhar";"189";"164";"25";"162";"27";"152";"37";"3";"null";"null";"0.8677248677248677";"0.13227513227513227";"0.8571428571428571";"0.14285714285714285";"0.8042328042328042";"0.19576719576719576";"0.015873015873015872";"104"
"4587473";"SnDp StHa";"2";"0";"2";"1";"1";"0";"2";"0";"null";"null";"0.0";"1.0";"0.5";"0.5";"0.0";"1.0";"0.0";"2"
"2695103";"Dipu Shakya";"15";"5";"10";"14";"1";"8";"7";"2";"null";"null";"0.3333333333333333";"0.6666666666666666";"0.9333333333333333";"0.06666666666666667";"0.5333333333333333";"0.4666666666666667";"0.13333333333333333";"4"
"2875325";"Erinbyrne";"117";"0";"117";"116";"1";"117";"0";"0";"null";"null";"0.0";"1.0";"0.9914529914529915";"0.008547008547008548";"1.0";"0.0";"0.0";"11"
"458641";"uvi";"86";"85";"1";"85";"1";"28";"58";"1";"null";"null";"0.9883720930232558";"0.011627906976744186";"0.9883720930232558";"0.011627906976744186";"0.32558139534883723";"0.6744186046511628";"0.011627906976744186";"1"
"401297";"mapmeld";"17";"10";"7";"15";"2";"16";"1";"0";"null";"null";"0.5882352941176471";"0.4117647058823529";"0.8823529411764706";"0.11764705882352941";"0.9411764705882353";"0.058823529411764705";"0.0";"7"
"2142137";"utkrist";"6";"0";"6";"5";"1";"5";"1";"0";"null";"null";"0.0";"1.0";"0.8333333333333334";"0.16666666666666666";"0.8333333333333334";"0.16666666666666666";"0.0";"3"
"4886487";"Melissa Shresttha";"2";"0";"2";"0";"2";"2";"0";"0";"null";"null";"0.0";"1.0";"0.0";"1.0";"1.0";"0.0";"0.0";"1"
"2871221";"JessieZ";"161";"0";"161";"160";"1";"150";"11";"0";"null";"null";"0.0";"1.0";"0.9937888198757764";"0.006211180124223602";"0.9316770186335404";"0.06832298136645963";"0.0";"2"
"4370396";"Rahul Singh Maharjan";"1334";"76";"1258";"1333";"1";"1065";"269";"14";"null";"null";"0.05697151424287856";"0.9430284857571214";"0.9992503748125937";"7.496251874062968E-4";"0.7983508245877061";"0.20164917541229385";"0.010494752623688156";"2"
"2875275";"Smitty OKC";"38";"0";"38";"37";"1";"38";"0";"0";"null";"null";"0.0";"1.0";"0.9736842105263158";"0.02631578947368421";"1.0";"0.0";"0.0";"1"
"2436996";"Patty Frontiera";"9";"0";"9";"8";"1";"9";"0";"0";"null";"null";"0.0";"1.0";"0.8888888888888888";"0.1111111111111111";"1.0";"0.0";"0.0";"2"
"3669909";"superwatermelon";"14";"13";"1";"13";"1";"14";"0";"0";"null";"null";"0.9285714285714286";"0.07142857142857142";"0.9285714285714286";"0.07142857142857142";"1.0";"0.0";"0.0";"1"
"2629504";"tattwa";"4";"0";"4";"3";"1";"0";"4";"0";"null";"null";"0.0";"1.0";"0.75";"0.25";"0.0";"1.0";"0.0";"1"
"4550636";"Suwal Prasiddha";"3";"1";"2";"2";"1";"3";"0";"0";"null";"null";"0.3333333333333333";"0.6666666666666666";"0.6666666666666666";"0.3333333333333333";"1.0";"0.0";"0.0";"3"
"2883458";"CKredell";"43";"0";"43";"42";"1";"43";"0";"0";"null";"null";"0.0";"1.0";"0.9767441860465116";"0.023255813953488372";"1.0";"0.0";"0.0";"6"
"1716144";"KatataK";"5";"0";"5";"4";"1";"5";"0";"0";"null";"null";"0.0";"1.0";"0.8";"0.2";"1.0";"0.0";"0.0";"2"
"2035636";"Bikramz";"42";"41";"1";"41";"1";"20";"22";"0";"null";"null";"0.9761904761904762";"0.023809523809523808";"0.9761904761904762";"0.023809523809523808";"0.47619047619047616";"0.5238095238095238";"0.0";"1"
"2883462";"firefighterpeter";"29";"0";"29";"0";"29";"29";"0";"0";"null";"null";"0.0";"1.0";"0.0";"1.0";"1.0";"0.0";"0.0";"5"
"3141505";"Shakya House";"1";"0";"1";"0";"1";"1";"0";"0";"null";"null";"0.0";"1.0";"0.0";"1.0";"1.0";"0.0";"0.0";"1"
"4268014";"poweroop";"5";"4";"1";"0";"5";"5";"0";"0";"null";"null";"0.8";"0.2";"0.0";"1.0";"1.0";"0.0";"0.0";"1"
"2879364";"cg_stclair";"8";"7";"1";"7";"1";"8";"0";"0";"null";"null";"0.875";"0.125";"0.875";"0.125";"1.0";"0.0";"0.0";"1"
"2883483";"tmharada";"100";"0";"100";"99";"1";"100";"0";"0";"null";"null";"0.0";"1.0";"0.99";"0.01";"1.0";"0.0";"0.0";"2"
"2875295";"engineerand";"255";"0";"255";"254";"1";"222";"33";"20";"null";"null";"0.0";"1.0";"0.996078431372549";"0.00392156862745098";"0.8705882352941177";"0.12941176470588237";"0.0784313725490196";"1"
"2858910";"ApoorvaLal";"13";"0";"13";"0";"13";"13";"0";"0";"null";"null";"0.0";"1.0";"0.0";"1.0";"1.0";"0.0";"0.0";"1"
"3178375";"LeTopographeFou";"3";"0";"3";"0";"3";"0";"3";"0";"null";"null";"0.0";"1.0";"0.0";"1.0";"0.0";"1.0";"0.0";"2"
"3276680";"Ranjan Adhikari";"156";"0";"156";"155";"1";"39";"117";"13";"null";"null";"0.0";"1.0";"0.9935897435897436";"0.00641025641025641";"0.25";"0.75";"0.08333333333333333";"1"
"2871185";"Lokendra";"11";"0";"11";"10";"1";"9";"2";"0";"null";"null";"0.0";"1.0";"0.9090909090909091";"0.09090909090909091";"0.8181818181818182";"0.18181818181818182";"0.0";"1"
"4390911";"annshress";"1";"0";"1";"0";"1";"0";"1";"0";"null";"null";"0.0";"1.0";"0.0";"1.0";"0.0";"1.0";"0.0";"1"
"2862998";"unpocorizado";"3";"0";"3";"2";"1";"3";"0";"0";"null";"null";"0.0";"1.0";"0.6666666666666666";"0.3333333333333333";"1.0";"0.0";"0.0";"1"
"700362";"tbsprs";"37";"13";"24";"36";"1";"26";"11";"0";"null";"null";"0.35135135135135137";"0.6486486486486487";"0.972972972972973";"0.02702702702702703";"0.7027027027027027";"0.2972972972972973";"0.0";"3"
"2883565";"siddharthan64";"67";"0";"67";"66";"1";"67";"0";"0";"null";"null";"0.0";"1.0";"0.9850746268656716";"0.014925373134328358";"1.0";"0.0";"0.0";"5"
"339917";"Hedaja";"313";"0";"313";"312";"1";"310";"3";"0";"null";"null";"0.0";"1.0";"0.9968051118210862";"0.003194888178913738";"0.9904153354632588";"0.009584664536741214";"0.0";"4"
"2899940";"paudelp";"5";"4";"1";"4";"1";"5";"0";"0";"null";"null";"0.8";"0.2";"0.8";"0.2";"1.0";"0.0";"0.0";"1"
"4931458";"Anup Dahal";"2";"1";"1";"0";"2";"2";"0";"0";"null";"null";"0.5";"0.5";"0.0";"1.0";"1.0";"0.0";"0.0";"1"
"3493880";"Sunil Bogati";"6";"0";"6";"0";"6";"1";"5";"4";"null";"null";"0.0";"1.0";"0.0";"1.0";"0.16666666666666666";"0.8333333333333334";"0.6666666666666666";"2"
"2875385";"ltung";"1";"0";"1";"0";"1";"1";"0";"0";"null";"null";"0.0";"1.0";"0.0";"1.0";"1.0";"0.0";"0.0";"1"
"2285553";"OVgaurab";"22";"0";"22";"0";"22";"21";"1";"0";"null";"null";"0.0";"1.0";"0.0";"1.0";"0.9545454545454546";"0.045454545454545456";"0.0";"5"
"2867199";"Ines Zalduendo";"755";"0";"755";"754";"1";"727";"28";"4";"null";"null";"0.0";"1.0";"0.9986754966887417";"0.0013245033112582781";"0.9629139072847682";"0.03708609271523179";"0.005298013245033113";"7"
"4841375";"Abhishek Chaturvedi";"1";"0";"1";"0";"1";"1";"0";"0";"null";"null";"0.0";"1.0";"0.0";"1.0";"1.0";"0.0";"0.0";"1"
"348126";"mitry";"437";"347";"90";"184";"253";"89";"348";"116";"null";"null";"0.7940503432494279";"0.20594965675057209";"0.42105263157894735";"0.5789473684210527";"0.2036613272311213";"0.7963386727688787";"0.2654462242562929";"28"
"102362";"ld50bdg";"44";"0";"44";"43";"1";"44";"0";"0";"null";"null";"0.0";"1.0";"0.9772727272727273";"0.022727272727272728";"1.0";"0.0";"0.0";"1"
"4489113";"Bhim Rokka";"6";"0";"6";"0";"6";"0";"6";"1";"null";"null";"0.0";"1.0";"0.0";"1.0";"0.0";"1.0";"0.16666666666666666";"5"
"2875338";"bhof";"114";"0";"114";"113";"1";"114";"0";"0";"null";"null";"0.0";"1.0";"0.9912280701754386";"0.008771929824561403";"1.0";"0.0";"0.0";"2"
"3157970";"Sailesh Kasaju";"5";"0";"5";"4";"1";"5";"0";"0";"null";"null";"0.0";"1.0";"0.8";"0.2";"1.0";"0.0";"0.0";"1"
"4001758";"mikaelamoschella";"288";"0";"288";"287";"1";"282";"6";"0";"null";"null";"0.0";"1.0";"0.9965277777777778";"0.003472222222222222";"0.9791666666666666";"0.020833333333333332";"0.0";"1"
"2871244";"LBett";"8";"0";"8";"7";"1";"0";"8";"0";"null";"null";"0.0";"1.0";"0.875";"0.125";"0.0";"1.0";"0.0";"1"
"2858947";"BaraSafarova";"686";"0";"686";"0";"686";"635";"51";"5";"null";"null";"0.0";"1.0";"0.0";"1.0";"0.9256559766763849";"0.07434402332361516";"0.007288629737609329";"5"
"2875328";"Jherbozo";"83";"0";"83";"82";"1";"83";"0";"0";"null";"null";"0.0";"1.0";"0.9879518072289156";"0.012048192771084338";"1.0";"0.0";"0.0";"2"
"4652970";"Sajan Shrestha";"1";"0";"1";"0";"1";"1";"0";"0";"null";"null";"0.0";"1.0";"0.0";"1.0";"1.0";"0.0";"0.0";"1"
"2883546";"GTV08";"327";"0";"327";"326";"1";"327";"0";"0";"null";"null";"0.0";"1.0";"0.9969418960244648";"0.0030581039755351682";"1.0";"0.0";"0.0";"6"
"1712104";"JacobT13";"78";"0";"78";"0";"78";"74";"4";"1";"null";"null";"0.0";"1.0";"0.0";"1.0";"0.9487179487179487";"0.05128205128205128";"0.01282051282051282";"1"
"2482131";"Gunaraj11";"14";"13";"1";"0";"14";"0";"14";"14";"null";"null";"0.9285714285714286";"0.07142857142857142";"0.0";"1.0";"0.0";"1.0";"1.0";"1"
"2875344";"Cranemania";"43";"0";"43";"42";"1";"28";"15";"15";"null";"null";"0.0";"1.0";"0.9767441860465116";"0.023255813953488372";"0.6511627906976745";"0.3488372093023256";"0.3488372093023256";"3"
"491515";"robertogeb";"1199";"0";"1199";"1198";"1";"1127";"72";"18";"null";"null";"0.0";"1.0";"0.9991659716430359";"8.340283569641367E-4";"0.9399499582985822";"0.060050041701417846";"0.015012510425354461";"17"
"4153282";"Owen Cradock";"1";"0";"1";"0";"1";"0";"1";"0";"null";"null";"0.0";"1.0";"0.0";"1.0";"0.0";"1.0";"0.0";"1"
